ӄԓявыԓя риӄукэтэ ивнин ытри ынкы варкыт гынин ӈэвъэн гэԓгыԓин мэмыԓя рагтыгъэ	ӄ ԓ я в ы ԓ я _ р и ӄ у к э т э _ ивнин _ ы т р и _ ы н к ы _ в а р к ы т _ г ы н и н _ ӈ э в ъ э н _ г э ԓ г ы ԓ и н _ м э м ы ԓ я _ р а г т ы г ъ э _
ӄԓявыԓ ынкъам купрэн ынанъомрычьын	ӄ ԓ я в ы ԓ _ ынкъам _ к у п р э н _ ы н а н ъ о м р ы ч ь ы н _
рытэнмавнэн ынӄо эргатык эквэтгъэт копрантыватысӄэквъат	р ы т э н м а в н э н _ ы н ӄ о _ э р г а т ы к _ э к в э т г ъ э т _ к о п р а н т ы в а т ы с ӄ э к в ъ а т _
риӄукэтэ гамгаваны нэнайӈоткоӄэн ӄоԓ	р и ӄ у к э т э _ г а м г а в а н ы _ н э н а й ӈ о т к о ӄ э н _ ӄ о ԓ _
ԓьунин ынӄо йыӈотконэн	ԓ ь у н и н _ ы н ӄ о _ й ы ӈ о т к о н э н _
эвын коԓё	э в ы н _ к о ԓ ё _
тыкгаткэта ивнин риӄукэтэ	т ы к г а т к э т а _ и в н и н _ р и ӄ у к э т э _
йыӈотконэн эвын коԓё	й ы ӈ о т к о н э н _ э в ы н _ к о ԓ ё _
тыкгаткэта	т ы к г а т к э т а _
ивнин риӄукэтэ ынкы	и в н и н _ р и ӄ у к э т э _ ы н к ы _
рытваннэнат риӄукэтэ ивнин	р ы т в а н н э н а т _ р и ӄ у к э т э _ и в н и н _
мачынан ынкы нытваркын ынӄо	м а ч ы н а н _ ы н к ы _ н ы т в а р к ы н _ ы н ӄ о _
эргатык купрэт ёпаннэнат эвын гакваԓен	э р г а т ы к _ к у п р э т _ ё п а н н э н а т _ э в ы н _ г а к в а ԓ е н _
ӈавмэмыԓчыӈын ынӄо рырагтаннэн ынкъам	ӈ а в м э м ы ԓ ч ы ӈ ы н _ ы н ӄ о _ р ы р а г т а н н э н _ ынкъам _
тэнуйгын йыннин	т э н у й г ы н _ й ы н н и н _
ыттъын ратвынэн рывэнӈынин	ы т т ъ ы н _ р а т в ы н э н _ р ы в э н ӈ ы н и н _
авынаёԓьэты ԓинԓиӈ йытонэн мэмыԓыткынык рытриԓнин ынӄо ӄԓявыԓ	а в ы н а ё ԓ ь э т ы _ ԓ и н ԓ и ӈ _ й ы т о н э н _ м э м ы ԓ ы т к ы н ы к _ р ы т р и ԓ н и н _ ы н ӄ о _ ӄ ԓ я в ы ԓ _
ӈытогъэ этъоӄайӄын рэсӄиквъи ԓюур	ӈ ы т о г ъ э _ э т ъ о ӄ а й ӄ ы н _ р э с ӄ и к в ъ и _ ԓ ю у р _
рымъэйӈэнин ӄԓявыԓя	р ы м ъ э й ӈ э н и н _ ӄ ԓ я в ы ԓ я _
ивнин ивнин ӈэвъэнйыръэ с амыным	и в н и н _ и в н и н _ ӈ э в ъ э н й ы р ъ э _ с _ а м ы н ы м _
аны ԓыгитэнчимгъуԓьын ӈэвысӄэтӄэй чама	а н ы _ ԓ ы г и т э н ч и м г ъ у ԓ ь ы н _ ӈ э в ы с ӄ э т ӄ э й _ ч а м а _
ныԓгэнываӈэӄэн ытԓыгэ ытԓьата	н ы ԓ г э н ы в а ӈ э ӄ э н _ ы т ԓ ы г э _ ы т ԓ ь а т а _
ынкъам	ынкъам _
ытԓенъюрык гыԓёо ныԓгыӄин ытԓён энмэн	ы т ԓ е н ъ ю р ы к _ г ы ԓ ё о _ н ы ԓ г ы ӄ и н _ ы т ԓ ё н _ э н м э н _
ӄуԓинымнымык	ӄ у ԓ и н ы м н ы м ы к _
ӄоԓ гатъыԓыӈоԓен ӈэвысӄэтӄэй амыным	ӄ о ԓ _ г а т ъ ы ԓ ы ӈ о ԓ е н _ ӈ э в ы с ӄ э т ӄ э й _ а м ы н ы м _
аны ԓыгитэнчимгъуԓьын ӈэвысӄэтӄэй чама ныԓгэнываӈэӄэн ытԓыгэ ытԓьата ынкъам ытԓенъюрык гыԓёо ныԓгыӄин ытԓён ынкыым мэтчымчек нытваӄэн нымнымӄэйык ӄоԓ эӈэӈыԓьын	а н ы _ ԓ ы г и т э н ч и м г ъ у ԓ ь ы н _ ӈ э в ы с ӄ э т ӄ э й _ ч а м а _ н ы ԓ г э н ы в а ӈ э ӄ э н _ ы т ԓ ы г э _ ы т ԓ ь а т а _ ы н к ъ а м _ ы т ԓ е н ъ ю р ы к _ г ы ԓ ё о _ н ы ԓ г ы ӄ и н _ ы т ԓ ё н _ ы н к ы ы м _ м э т ч ы м ч е к _ н ы т в а ӄ э н _ н ы м н ы м ӄ э й ы к _ ӄ о ԓ _ э ӈ э ӈ ы ԓ ь ы н _
ӄынвэр ытԓыгын иквъи	ӄ ы н в э р _ ы т ԓ ы г ы н _ и к в ъ и _
наӄам ӈутку варкын мэтчымче	н а ӄ а м _ ӈ у т к у _ в а р к ы н _ м э т ч ы м ч е _
нымнымӄэйык ԓыӈыр амытва рытъё эӈэӈыԓьын ӈэвъэнэ ивнин юрэӄым нъынмэԓевэннин наӄам	н ы м н ы м ӄ э й ы к _ ԓ ы ӈ ы р _ а м ы т в а _ р ы т ъ ё _ э ӈ э ӈ ы ԓ ь ы н _ ӈ э в ъ э н э _ и в н и н _ ю р э ӄ ы м _ н ъ ы н м э ԓ е в э н н и н _ н а ӄ а м _
ытԓенъюӄэгти нытэргыръоӄэнат ԓиӈвиттэ чакэттэты эквэтгъи	ы т ԓ е н ъ ю ӄ э г т и _ н ы т э р г ы р ъ о ӄ э н а т _ ԓ и ӈ в и т т э _ ч а к э т т э т ы _ э к в э т г ъ и _
ытԓыгын аӈаӈыԓьэты пыкиргъи нымнымӄэйык иквъэт эмитԓёным	ы т ԓ ы г ы н _ а ӈ а ӈ ы ԓ ь э т ы _ п ы к и р г ъ и _ н ы м н ы м ӄ э й ы к _ и к в ъ э т _ э м и т ԓ ё н ы м _
ынин яраӈы ӄытгъи ӈэнри ярачыкогты рэсӄиквъи ԓюур вай начайпатгъан чайпанмаым нывэтгавчетӄэнат нэнамӈыԓёӄэн рэмкыԓьын	ы н и н _ я р а ӈ ы _ ӄ ы т г ъ и _ ӈ э н р и _ я р а ч ы к о г т ы _ р э с ӄ и к в ъ и _ ԓ ю у р _ в а й _ н а ч а й п а т г ъ а н _ ч а й п а н м а ы м _ н ы в э т г а в ч е т ӄ э н а т _ н э н а м ӈ ы ԓ ё ӄ э н _ р э м к ы ԓ ь ы н _
мэӈӄо етгъи чаёпԓыткогъат ынӄо эквэтгъэт пыкиргъэт ԓыгэн	м э ӈ ӄ о _ е т г ъ и _ ч а ё п ԓ ы т к о г ъ а т _ ы н ӄ о _ э к в э т г ъ э т _ п ы к и р г ъ э т _ ԓ ы г э н _
эвыр йъонэн тъытԓьэн эчги	э в ы р _ й ъ о н э н _ т ъ ы т ԓ ь э н _ э ч г и _
вуԓӄытвигъи ынраӄ эԓьоткомгой коԓё	в у ԓ ӄ ы т в и г ъ и _ ы н р а ӄ _ э ԓ ь о т к о м г о й _ к о ԓ ё _
аны ныԓгикэԓьэткуԓьэтӄин чама ԓыгэн ныԓгэярарпэгԓяръоӄэн наӄам тъытԓьэн ыныкгиӈкы нинэнтыӄин эргатык ԓыгинъэ кыеквъи эӈэӈыԓьын	а н ы _ н ы ԓ г и к э ԓ ь э т к у ԓ ь э т ӄ и н _ ч а м а _ ԓ ы г э н _ н ы ԓ г э я р а р п э г ԓ я р ъ о ӄ э н _ н а ӄ а м _ т ъ ы т ԓ ь э н _ ы н ы к г и ӈ к ы _ н и н э н т ы ӄ и н _ э р г а т ы к _ ԓ ы г и н ъ э _ к ы е к в ъ и _ э ӈ э ӈ ы ԓ ь ы н _
рыгъевнин тъытԓьэн ынкы вусӄымчыку нэнанпэгԓяръовӄэн	р ы г ъ е в н и н _ т ъ ы т ԓ ь э н _ ы н к ы _ в у с ӄ ы м ч ы к у _ н э н а н п э г ԓ я р ъ о в ӄ э н _
ԓыгэн икумиӈкыри нинэнтивыӄин	ԓ ы г э н _ и к у м и ӈ к ы р и _ н и н э н т и в ы ӄ и н _
ынӄо тъэче кивыткугъиым иквъи итыкым	ы н ӄ о _ т ъ э ч е _ к и в ы т к у г ъ и ы м _ и к в ъ и _ и т ы к ы м _
вай ԓыгэн ӈэранъыԓё рэмэԓеквъэ нивӄинэт авынраԓьыт вынэ ынан мытрэркурӈын ӄынвэр рагтыгъэ эӈэӈыԓьын авынраԓьа ыныкагты	в а й _ ԓ ы г э н _ ӈ э р а н ъ ы ԓ ё _ р э м э ԓ е к в ъ э _ н и в ӄ и н э т _ а в ы н р а ԓ ь ы т _ в ы н э _ ы н а н _ м ы т р э р к у р ӈ ы н _ ӄ ы н в э р _ р а г т ы г ъ э _ э ӈ э ӈ ы ԓ ь ы н _ а в ы н р а ԓ ь а _ ы н ы к а г т ы _
нэймитын ԓыгэчьыԓьын раквытчыӈын ынкъам ԓымӈэ мооӄор	н э й м и т ы н _ ԓ ы г э ч ь ы ԓ ь ы н _ р а к в ы т ч ы ӈ ы н _ ы н к ъ а м _ ԓ ы м ӈ э _ м о о ӄ о р _
ынӄоры рэмкын	ы н ӄ о р ы _ р э м к ы н _
эраткомгоӈӈой аны таӈэтъо	э р а т к о м г о ӈ ӈ о й _ а н ы _ т а ӈ э т ъ о _
ӈэвысӄэтӄэй гаԓгэтъыԓыӈоԓен тэкэм ԓюур вай эрама	ӈ э в ы с ӄ э т ӄ э й _ г а ԓ г э т ъ ы ԓ ы ӈ о ԓ е н _ т э к э м _ ԓ ю у р _ вай _ э р а м а _
въигъи наӄам ӄытԓыги ԓюӈынмэԓевэтэ рыннин	в ъ и г ъ и _ н а ӄ а м _ ӄ ы т ԓ ы г и _ ԓ ю ӈ ы н м э ԓ е в э т э _ р ы н н и н _
ынӄоым ынӄэн эӈэӈыԓьын	ы н ӄ о ы м _ ы н ӄ э н _ э ӈ э ӈ ы ԓ ь ы н _
танԓёнръэԓягта гитԓин ԓыгэн таӈӄонпы эвытрыкэ гэнъэтԓин	т а н ԓ ё н р ъ э ԓ я г т а _ г и т ԓ и н _ ԓ ы г э н _ т а ӈ ӄ о н п ы _ э в ы т р ы к э _ г э н ъ э т ԓ и н _
этъым ԓыгэыяагты гаяԓгытԓен ымто амын ӄэгԓынангэт эты эӈэӈыԓьыт ныԓгинъыръыӄинэт с энмэн нивӄин ынанчинит ынӄэн	э т ъ ы м _ ԓ ы г э ы я а г т ы _ г а я ԓ г ы т ԓ е н _ ы м т о _ а м ы н _ ӄ э г ԓ ы н а н г э т _ э т ы _ э ӈ э ӈ ы ԓ ь ы т _ н ы ԓ г и н ъ ы р ъ ы ӄ и н э т _ с _ э н м э н _ н и в ӄ и н _ ы н а н ч и н и т _ ы н ӄ э н _
гатваԓен тэԓенъеп энмэн нивӄин ынанчинит эвыр	г а т в а ԓ е н _ т э ԓ е н ъ е п _ э н м э н _ н и в ӄ и н _ ы н а н ч и н и т _ э в ы р _
мэӈин ратъыԓыӈоркын	м э ӈ и н _ р а т ъ ы ԓ ы ӈ о р к ы н _
ӄэнагтыркынэтык ымыԓьо амӄынъычо	ӄ э н а г т ы р к ы н э т ы к _ ы м ы ԓ ь о _ а м ӄ ы н ъ ы ч о _
нинивӄинэт ымыԓьо гатакэчгыӄайма ӄитгытык ӄываԓёмгытык ыныкит	н и н и в ӄ и н э т _ ы м ы ԓ ь о _ г а т а к э ч г ы ӄ а й м а _ ӄ и т г ы т ы к _ ӄ ы в а ԓ ё м г ы т ы к _ ы н ы к и т _
ыннэн уйӈэ	ы н н э н _ у й ӈ э _
этэкичгыӄэйкэ ритгъэ ӄоԓ	э т э к и ч г ы ӄ э й к э _ р и т г ъ э _ ӄ о ԓ _
ынин ройыръыкэн рэвъигъэ эргатык ӄытръугъэт ымыԓьо гэтэкичгэ гитԓинэт ӄоԓетъыԓё ӄутынин	ы н и н _ р о й ы р ъ ы к э н _ р э в ъ и г ъ э _ э р г а т ы к _ ӄ ы т р ъ у г ъ э т _ ы м ы ԓ ь о _ г э т э к и ч г э _ г и т ԓ и н э т _ ӄ о ԓ е т ъ ы ԓ ё _ ӄ у т ы н и н _
экык тъыԓыӈогъэ эргатык	э к ы к _ т ъ ы ԓ ы ӈ о г ъ э _ э р г а т ы к _
йыннэн	й ы н н э н _
эӈэӈыԓьын иквъи эӈэӈыԓьэ	э ӈ э ӈ ы ԓ ь ы н _ и к в ъ и _ э ӈ э ӈ ы ԓ ь э _
ивнин эргатык ӄытгъи эӈэӈыԓьын	и в н и н _ э р г а т ы к _ ӄ ы т г ъ и _ э ӈ э ӈ ы ԓ ь ы н _
эвын гъэӄэрэԓин тъытԓьэн	э в ы н _ г ъ э ӄ э р э ԓ и н _ т ъ ы т ԓ ь э н _
атав иԓьуткугъи авынэԓьоткогты въигъи	а т а в _ и ԓ ь у т к у г ъ и _ а в ы н э ԓ ь о т к о г т ы _ в ъ и г ъ и _
экык ԓюур	э к ы к _ ԓ ю у р _
ытԓыгын иквъи эӈэӈыԓьэ пынԓёнэнат еп гымнан гымнин иԓьуткукэԓы эйӈэвкэ еп	ы т ԓ ы г ы н _ и к в ъ и _ э ӈ э ӈ ы ԓ ь э _ п ы н ԓ ё н э н а т _ е п _ г ы м н а н _ г ы м н и н _ и ԓ ь у т к у к э ԓ ы _ э й ӈ э в к э _ е п _
эпкиркэ въигъи ыныкит нъыпкиргъэн	э п к и р к э _ в ъ и г ъ и _ ы н ы к и т _ н ъ ы п к и р г ъ э н _
ӄырым нъывъигъэн этынва пынԓёнэн	ӄ ы р ы м _ н ъ ы в ъ и г ъ э н _ э т ы н в а _ п ы н ԓ ё н э н _
эӈэӈыԓьэ ивнин этынва пынԓёнэн	э ӈ э ӈ ы ԓ ь э _ ивнин _ э т ы н в а _ п ы н ԓ ё н э н _
эӈэӈыԓьын иквъи ыныкит энамынгыкватка ринэнтыӈ нэмэ ӄоԓ	э ӈ э ӈ ы ԓ ь ы н _ и к в ъ и _ ы н ы к и т _ э н а м ы н г ы к в а т к а _ р и н э н т ы ӈ _ н э м э _ ӄ о ԓ _
рэвъигъэ экык	р э в ъ и г ъ э _ э к ы к _
этынва ивнин мынгыкво йыԓнинэт мытԓыӈэн ӄорат	э т ы н в а _ ивнин _ м ы н г ы к в о _ й ы ԓ н и н э т _ м ы т ԓ ы ӈ э н _ ӄ о р а т _
ӈирэӄ ыттъыт ӈыроӄ	ӈ и р э ӄ _ ы т т ъ ы т _ ӈ ы р о ӄ _
игнэԓгыт эӈэӈыԓьын рагтыгъэ нэмэ	и г н э ԓ г ы т _ э ӈ э ӈ ы ԓ ь ы н _ р а г т ы г ъ э _ н э м э _
ӄоԓ экык тъыԓыӈогъэ нэмэ йыннэн эӈэӈыԓьын нэмэ	ӄ о ԓ _ э к ы к _ т ъ ы ԓ ы ӈ о г ъ э _ н э м э _ й ы н н э н _ э ӈ э ӈ ы ԓ ь ы н _ н э м э _
ӄытгъи иԓьуткугъи ынкъам иквъи ӄэнамынгыкватгэ пытӄымыкыӈ мынгыкваннэн эквэтгъи	ӄ ы т г ъ и _ и ԓ ь у т к у г ъ и _ ы н к ъ а м _ и к в ъ и _ ӄ э н а м ы н г ы к в а т г э _ п ы т ӄ ы м ы к ы ӈ _ м ы н г ы к в а н н э н _ э к в э т г ъ и _
эӈэӈыԓьын ԓыгэн эквэтгъи въигъи	э ӈ э ӈ ы ԓ ь ы н _ ԓ ы г э н _ э к в э т г ъ и _ в ъ и г ъ и _
тъытԓьэн ытԓыгын	т ъ ы т ԓ ь э н _ ы т ԓ ы г ы н _
иквъи эккэт	и к в ъ и _ э к к э т _
тэԓпыркыт ынраӄ ӈээкык тъыԓыӈогъэ	т э ԓ п ы р к ы т _ ы н р а ӄ _ ӈ э э к ы к _ т ъ ы ԓ ы ӈ о г ъ э _
нэмэ	н э м э _
эӈэӈыԓьын йыннэн	э ӈ э ӈ ы ԓ ь ы н _ й ы н н э н _
ивнин эӈэӈыԓьын	и в н и н _ э ӈ э ӈ ы ԓ ь ы н _
нэмэ ӄытгъи нэмэ иԓьуткугъи	н э м э _ ӄ ы т г ъ и _ н э м э _ и ԓ ь у т к у г ъ и _
иквъи ытԓыгэ	и к в ъ и _ ы т ԓ ы г э _
ивнин этынва	и в н и н _ э т ы н в а _
ивнин	и в н и н _
эӈэӈыԓьын иквъи анӈэнайпыгъэ эӈэӈыԓьын	э ӈ э ӈ ы ԓ ь ы н _ и к в ъ и _ а н ӈ э н а й п ы г ъ э _ э ӈ э ӈ ы ԓ ь ы н _
эквэтгъи ԓёгмынгыквата ымыԓьо ԓюӈвъитэ	э к в э т г ъ и _ ԓ ё г м ы н г ы к в а т а _ ы м ы ԓ ь о _ ԓ ю ӈ в ъ и т э _
итгъэт ынӄоры эӈэӈыԓьын эӄу нэтчын	и т г ъ э т _ ы н ӄ о р ы _ э ӈ э ӈ ы ԓ ь ы н _ э ӄ у _ н э т ч ы н _
ымыԓьо нивӄинэт	ы м ы ԓ ь о _ н и в ӄ и н э т _
ымыԓьорык эӄу нэтчын ынӈин	ы м ы ԓ ь о р ы к _ э ӄ у _ н э т ч ы н _ ы н ӈ и н _
тэԓенъепкин эӈэӈыԓьыт нырагаймычьавӈыӄэнат с ыԓвыԓю эԓек нынмыткоӄэн ипэ	т э ԓ е н ъ е п к и н _ э ӈ э ӈ ы ԓ ь ы т _ н ы р а г а й м ы ч ь а в ӈ ы ӄ э н а т _ с _ ы ԓ в ы ԓ ю _ э ԓ е к _ н ы н м ы т к о ӄ э н _ и п э _
ӄоԓ итгъэт увиԓьэтгъэт ыԓвытъуԓе	ӄ о ԓ _ и т г ъ э т _ у в и ԓ ь э т г ъ э т _ ы ԓ в ы т ъ у ԓ е _
ԓыгэн ынкы напэԓянат уӄӄэмчыку эръэйыръын ынкъам	ԓ ы г э н _ ы н к ы _ н а п э ԓ я н а т _ у ӄ ӄ э м ч ы к у _ э р ъ э й ы р ъ ы н _ ы н к ъ а м _
ыпаԓгын эвын	ы п а ԓ г ы н _ э в ы н _
етгъэт рэӄэ	е т г ъ э т _ р э ӄ э _
ыпаԓгын гаткоӈӈоԓен ымы эръэт гэтъэттывиԓинэт ӄоԓ	ы п а ԓ г ы н _ г а т к о ӈ ӈ о ԓ е н _ ы м ы _ э р ъ э т _ г э т ъ э т т ы в и ԓ и н э т _ ӄ о ԓ _
ынээԓьын иквъи кита	ы н э э ԓ ь ы н _ и к в ъ и _ к и т а _
ӄоԓ чайвыткоӈӈок ныпэԓятын	ӄ о ԓ _ ч а й в ы т к о ӈ ӈ о к _ н ы п э ԓ я т ы н _
атав гынрыру мыныԓгын	а т а в _ г ы н р ы р у _ м ы н ы ԓ г ы н _
ръэнут	р ъ э н у т _
рэркын мури амӄынӈыток	р э р к ы н _ м у р и _ а м ӄ ы н ӈ ы т о к _
ымыԓьо ыԓвэгиԓигъэт ӈыраӄав пэԓятгъэ ынанӈэнчьан	ы м ы ԓ ь о _ ы ԓ в э г и ԓ и г ъ э т _ ӈ ы р а ӄ а в _ п э ԓ я т г ъ э _ ы н а н ӈ э н ч ь а н _
пэԓятыйгот нэнтын тытԓык атчыгъэ ынӄэн оравэтԓьан	п э ԓ я т ы й г о т _ н э н т ы н _ т ы т ԓ ы к _ а т ч ы г ъ э _ ы н ӄ э н _ о р а в э т ԓ ь а н _
эвын амгынотъыԓё нынъэԓӄин	э в ы н _ а м г ы н о т ъ ы ԓ ё _ н ы н ъ э ԓ ӄ и н _
ԓюур	ԓ ю у р _
ранмэйпык	р а н м э й п ы к _
вииԓетгъи ԓыгэн ынкы	в и и ԓ е т г ъ и _ ԓ ы г э н _ ы н к ы _
эӄуԓикэ нъатчаӄэн эмӄэԓеԓвынэ нивӄин вэчьым	э ӄ у ԓ и к э _ н ъ а т ч а ӄ э н _ э м ӄ э ԓ е ԓ в ы н э _ н и в ӄ и н _ в э ч ь ы м _
ӈотӄэн ныетӄин эвын	ӈ о т ӄ э н _ н ы е т ӄ и н _ э в ы н _
рэгъи	р э г ъ и _
таӈамъыттъымъеквэйӈын ӈэвъэнйыръын авэтываӄ ӄԓявыԓя пэнрынэн аны энмэн гэтэйкэвԓинэт ԓюур амъыттъымъеквэйӈа	т а ӈ а м ъ ы т т ъ ы м ъ е к в э й ӈ ы н _ ӈ э в ъ э н й ы р ъ ы н _ а в э т ы в а ӄ _ ӄ ԓ я в ы ԓ я _ п э н р ы н э н _ а н ы _ э н м э н _ г э т э й к э в ԓ и н э т _ ԓ ю у р _ а м ъ ы т т ъ ы м ъ е к в э й ӈ а _
авынтайкавэты ивнин йъарат	а в ы н т а й к а в э т ы _ и в н и н _ й ъ а р а т _
амӄԓявыԓторэ варкынэтык	а м ӄ ԓ я в ы ԓ т о р э _ в а р к ы н э т ы к _
яйвачгыргыторэ	я й в а ч г ы р г ы т о р э _
вэԓерым	в э ԓ е р ы м _
ваӈэԓьо митыркын аны энмэн оравэтԓьаӄай	в а ӈ э ԓ ь о _ м и т ы р к ы н _ а н ы _ э н м э н _ о р а в э т ԓ ь а ӄ а й _
гувиԓьэтԓин амъыттъымъеквэйӈын тыргэтъюунин гыргоча	г у в и ԓ ь э т ԓ и н _ а м ъ ы т т ъ ы м ъ е к в э й ӈ ы н _ т ы р г э т ъ ю у н и н _ г ы р г о ч а _
ыпаԓга	ы п а ԓ г а _
энайпаннэн ынӄо иквъи	э н а й п а н н э н _ ы н ӄ о _ и к в ъ и _
ӈэвъэнйыръын тагам ораӈанӄо ӄыԓиги ԓыганԓыгъэ	ӈ э в ъ э н й ы р ъ ы н _ т а г а м _ о р а ӈ а н ӄ о _ ӄ ы ԓ и г и _ ԓ ы г а н ԓ ы г ъ э _
оравэтԓьан 	о р а в э т ԓ ь а н _ _
ӈэвъэнйыръэ ивнин эвын	ӈ э в ъ э н й ы р ъ э _ ивнин _ э в ы н _
гитэнин 	г и т э н и н _ _
йыӄӄайъым ӈэвъэнйыръын ынкы	й ы ӄ ӄ а й ъ ы м _ ӈ э в ъ э н й ы р ъ ы н _ ы н к ы _
гитэнин оравэтԓьата	г и т э н и н _ о р а в э т ԓ ь а т а _
ивнин матанэн еп чейвыткуԓьыт	и в н и н _ м а т а н э н _ е п _ ч е й в ы т к у ԓ ь ы т _
эпкиркэ увиԓьэтгъи ӈэвъэнйыръын	э п к и р к э _ у в и ԓ ь э т г ъ и _ ӈ э в ъ э н й ы р ъ ы н _
ԓюур пыкиргъэт ӈыроргарэ ӈытогъэ	ԓ ю у р _ п ы к и р г ъ э т _ ӈ ы р о р г а р э _ ӈ ы т о г ъ э _
ӈэвъэнйыръын ԓыгэкоргаквъат ынинэԓьыт рэгъэт чоттагнэты	ӈ э в ъ э н й ы р ъ ы н _ ԓ ы г э к о р г а к в ъ а т _ ы н и н э ԓ ь ы т _ р э г ъ э т _ ч о т т а г н э т ы _
ынанынпычьа матанэн	ы н а н ы н п ы ч ь а _ м а т а н э н _
ӄоԓ анӈэнайпыгъэ	ӄ о ԓ _ а н ӈ э н а й п ы г ъ э _
инэԓьуԓьын чейвыткугъэт	и н э ԓ ь у ԓ ь ы н _ ч е й в ы т к у г ъ э т _
нэмэ ӈыроргарэ	н э м э _ ӈ ы р о р г а р э _
ӄоԓ пэԓятгъэ ёрочыко нъэптыӄин ӈэвъэнйыръын	ӄ о ԓ _ п э ԓ я т г ъ э _ ё р о ч ы к о _ н ъ э п т ы ӄ и н _ ӈ э в ъ э н й ы р ъ ы н _
ӄԓявыԓ рэсӄиквъи	ӄ ԓ я в ы ԓ _ р э с ӄ и к в ъ и _
ивнин вынэ	и в н и н _ в ы н э _
ӄырым эԓгыӄай эйминнин	ӄ ы р ы м _ э ԓ г ы ӄ а й _ э й м и н н и н _
чит выԓгыпыркынэн ԓюур	ч и т _ в ы ԓ г ы п ы р к ы н э н _ ԓ ю у р _
вытры иргъи оравэтԓьан тымнэн ӄытԓыги эӄыԓпэ нэԓгычыку рычымӄэннин кыԓтынин майык	в ы т р ы _ и р г ъ и _ о р а в э т ԓ ь а н _ т ы м н э н _ ӄ ы т ԓ ы г и _ э ӄ ы ԓ п э _ н э ԓ г ы ч ы к у _ р ы ч ы м ӄ э н н и н _ к ы ԓ т ы н и н _ м а й ы к _
рыннин чейвыткуԓьыт етгъэт	р ы н н и н _ ч е й в ы т к у ԓ ь ы т _ е т г ъ э т _
ӈэвъэнйыръын никвъэн	ӈ э в ъ э н й ы р ъ ы н _ н и к в ъ э н _
ӈэвысӄэтэ ивнинэт	ӈ э в ы с ӄ э т э _ и в н и н э т _
ынръам ӄоԓ пэԓятгъэ ынанынпычьын майгэӈкы	ы н р ъ а м _ ӄ о ԓ _ п э ԓ я т г ъ э _ ы н а н ы н п ы ч ь ы н _ м а й г э ӈ к ы _
ныгатгаткоӄэн ԓюур	н ы г а т г а т к о ӄ э н _ ԓ ю у р _
ԓявтэты ръэнут эрэтгъи маԓенэн эвыр	ԓ я в т э т ы _ р ъ э н у т _ э р э т г ъ и _ м а ԓ е н э н _ э в ы р _
гитэнин мутԓымуԓ иквъи эмӄэԓеԓвынэ	г и т э н и н _ м у т ԓ ы м у ԓ _ и к в ъ и _ э м ӄ э ԓ е ԓ в ы н э _
ынръам ръэнут нэмэ	ы н р ъ а м _ р ъ э н у т _ н э м э _
гатгаткоӈӈогъэ нэмэ йиннин мутԓе ӄынвэр	г а т г а т к о ӈ ӈ о г ъ э _ н э м э _ й и н н и н _ м у т ԓ е _ ӄ ы н в э р _
наԓгымай рырыткунин 	н а ԓ г ы м а й _ р ы р ы т к у н и н _ _
эвын ынкы ԓьунин ыргин ытԓеӈи ӄытԓыги	э в ы н _ ы н к ы _ ԓ ь у н и н _ ы р г и н _ ы т ԓ е ӈ и _ ӄ ы т ԓ ы г и _
ӈавъанйыръиӈа ганмыԓен ԓыгэн авъеткынка нэмэ	ӈ а в ъ а н й ы р ъ и ӈ а _ г а н м ы ԓ е н _ ԓ ы г э н _ а в ъ е т к ы н к а _ н э м э _
румэкэвнин	р у м э к э в н и н _
ӄутти	ӄ у т т и _
ытԓенъют етгъэт 	ы т ԓ е н ъ ю т _ е т г ъ э т _ _
винвэ ивнинэт	в и н в э _ и в н и н э т _
ынӄо эргатык ымыԓьо чейвыткугъэт нутэк	ы н ӄ о _ э р г а т ы к _ ы м ы ԓ ь о _ ч е й в ы т к у г ъ э т _ н у т э к _
увэрайӈын	у в э р а й ӈ ы н _
нэтэйкын	н э т э й к ы н _
аны таӈымъыԓёӈэт гэкымъыгичиԓинэт ԓыгэн	а н ы _ т а ӈ ы м ъ ы ԓ ё ӈ э т _ г э к ы м ъ ы г и ч и ԓ и н э т _ ԓ ы г э н _
увэрайӈык ныёԓьатӄэнат ӄынвэр ыттъымиԓ майӈаӈӈогъат кымъыгинив нэтэйкын аны таӈымъыԓёӈэт	у в э р а й ӈ ы к _ н ы ё ԓ ь а т ӄ э н а т _ ӄ ы н в э р _ ы т т ъ ы м и ԓ _ м а й ӈ а ӈ ӈ о г ъ а т _ к ы м ъ ы г и н и в _ н э т э й к ы н _ а н ы _ т а ӈ ы м ъ ы ԓ ё ӈ э т _
гэкымъыгичиԓинэт	г э к ы м ъ ы г и ч и ԓ и н э т _
ԓыгэн увэрайӈык ныёԓьатӄэнат ӄынвэр ыттъымиԓ майӈаӈӈогъат	ԓ ы г э н _ у в э р а й ӈ ы к _ н ы ё ԓ ь а т ӄ э н а т _ ӄ ы н в э р _ ы т т ъ ы м и ԓ _ м а й ӈ а ӈ ӈ о г ъ а т _
кымъыгинив ынӄо эргатык ӈэвъэнйыръын нываӈэӄэн чотыткынык	к ы м ъ ы г и н и в _ ы н ӄ о _ э р г а т ы к _ ӈ э в ъ э н й ы р ъ ы н _ н ы в а ӈ э ӄ э н _ ч о т ы т к ы н ы к _
ԓюур кагынмыткыната ӄочеԓгыԓгыӄай ԓьунин ӈэвъэнйыръын иквъи	ԓ ю у р _ к а г ы н м ы т к ы н а т а _ ӄ о ч е ԓ г ы ԓ г ы ӄ а й _ ԓ ь у н и н _ ӈ э в ъ э н й ы р ъ ы н _ и к в ъ и _
ӄочеԓгыԓгыӄай ԓюур иквъи ивкэ ӄун миквыт	ӄ о ч е ԓ г ы ԓ г ы ӄ а й _ ԓ ю у р _ и к в ъ и _ и в к э _ ӄ у н _ м и к в ы т _
гыныкы нэтэйкын	г ы н ы к ы _ н э т э й к ы н _
нутэк увэрайӈын ӄэгԓын эргатык чайвытконвэпы	н у т э к _ у в э р а й ӈ ы н _ ӄ э г ԓ ы н _ э р г а т ы к _ ч а й в ы т к о н в э п ы _
етык никвъэн ӈэвысӄэтэ ивнинэт виин ӈотӄэнат чемынгыт ӄынчичьэркыниткы кэргымма	е т ы к _ н и к в ъ э н _ ӈ э в ы с ӄ э т э _ и в н и н э т _ в и и н _ ӈ о т ӄ э н а т _ ч е м ы н г ы т _ ӄ ы н ч и ч ь э р к ы н и т к ы _ к э р г ы м м а _
ԓюур эвыр нэгитэн гагыргоԓятԓен нырэпириӈӄин	ԓ ю у р _ э в ы р _ н э г и т э н _ г а г ы р г о ԓ я т ԓ е н _ н ы р э п и р и ӈ ӄ и н _
ныԓвавӄэн пирик гыргоԓятгъэ	н ы ԓ в а в ӄ э н _ п и р и к _ г ы р г о ԓ я т г ъ э _
ӄытԓыги ӄучиԓгыӄэе	ӄ ы т ԓ ы г и _ ӄ у ч и ԓ г ы ӄ э е _
гангыргоԓявԓен ныпичгыӄин вэгрэтэм	г а н г ы р г о ԓ я в ԓ е н _ н ы п и ч г ы ӄ и н _ в э г р э т э м _
с ганымыԓьавԓен нынну ынкы вэгрэтэм	с _ г а н ы м ы ԓ ь а в ԓ е н _ н ы н н у _ ы н к ы _ в э г р э т э м _
аны ытԓён таӈвэнъым ныпичгыӄин	а н ы _ ы т ԓ ё н _ т а ӈ в э н ъ ы м _ н ы п и ч г ы ӄ и н _
тэӈпэнин ӄонратваԓьын ымыӈ	т э ӈ п э н и н _ ӄ о н р а т в а ԓ ь ы н _ ы м ы ӈ _
нымным ванэван чымче	н ы м н ы м _ в а н э в а н _ ч ы м ч е _
нытван миӈкыри	н ы т в а н _ м и ӈ к ы р и _
ӄун найыԓгавӄэн	ӄ у н _ н а й ы ԓ г а в ӄ э н _
рэԓӄынӈыт мэӈӄокэнат	р э ԓ ӄ ы н ӈ ы т _ м э ӈ ӄ о к э н а т _
рэмкыԓьыт кытамчачва	р э м к ы ԓ ь ы т _ к ы т а м ч а ч в а _
ынкъам ынӄэната	ынкъам _ ы н ӄ э н а т а _
найыԓгавӄэн наӄам ытԓён ԓымыԓьын ӈирэнӈэвыԓьын	н а й ы ԓ г а в ӄ э н _ н а ӄ а м _ ы т ԓ ё н _ ԓ ы м ы ԓ ь ы н _ ӈ и р э н ӈ э в ы ԓ ь ы н _
ытԓён еп	ы т ԓ ё н _ е п _
ԓыгэн аатчек	ԓ ы г э н _ а а т ч е к _
эквыргъам ԓыгэн гэԓеԓютԓин	э к в ы р г ъ а м _ ԓ ы г э н _ г э ԓ е ԓ ю т ԓ и н _
эвын ԓыгэн гэмэчынпэвыԓгэтԓин	э в ы н _ ԓ ы г э н _ г э м э ч ы н п э в ы ԓ г э т ԓ и н _
ӄуԓитгивик ӄоԓ	ӄ у ԓ и т г и в и к _ ӄ о ԓ _
ӈэвъэн рыԓейвынин ӄаагты ынкы	ӈ э в ъ э н _ р ы ԓ е й в ы н и н _ ӄ а а г т ы _ ы н к ы _
эвын гагроръоԓен ӄаат эвын	э в ы н _ г а г р о р ъ о ԓ е н _ ӄ а а т _ э в ы н _
ныгръоӄэнат	н ы г р ъ о ӄ э н а т _
ӈэнку ӄаатагнык	ӈ э н к у _ ӄ а а т а г н ы к _
гытгык ӄача пэнъёԓгын нэтэйкын наӄам ӈэйгиӈкы нытваӄэн	г ы т г ы к _ ӄ а ч а _ п э н ъ ё ԓ г ы н _ н э т э й к ы н _ н а ӄ а м _ ӈ э й г и ӈ к ы _ н ы т в а ӄ э н _
эвыр	э в ы р _
ӈэԓвыԓ гытоԓыӈкы	ӈ э ԓ в ы ԓ _ г ы т о ԓ ы ӈ к ы _
нытваӄэн тэкэм	н ы т в а ӄ э н _ т э к э м _
пэтыкэԓвайынвык увэмгогъат	п э т ы к э ԓ в а й ы н в ы к _ у в э м г о г ъ а т _
ынкы пэтыраԓӄаӈынвык	ы н к ы _ п э т ы р а ԓ ӄ а ӈ ы н в ы к _
пэтырытын ныԓгинымкыӄин	п э т ы р ы т ы н _ н ы ԓ г и н ы м к ы ӄ и н _
нарычгытваӄэн ывэӄуч	н а р ы ч г ы т в а ӄ э н _ ы в э ӄ у ч _
ӈэвъэным нувиӄин ынӄо мачгыргоԓягты ӈэвысӄэт уӈэԓгъи ынкы ууркиткугъи	ӈ э в ъ э н ы м _ н у в и ӄ и н _ ы н ӄ о _ м а ч г ы р г о ԓ я г т ы _ ӈ э в ы с ӄ э т _ у ӈ э ԓ г ъ и _ ы н к ы _ у у р к и т к у г ъ и _
ӈэвысӄэт ынӄо	ӈ э в ы с ӄ э т _ ы н ӄ о _
ываӄочегты ӄытгъи эвтыԓягты нэмэым ӈан нунрэпэтӄин тыԓяма	ы в а ӄ о ч е г т ы _ ӄ ы т г ъ и _ э в т ы ԓ я г т ы _ н э м э ы м _ ӈ а н _ н у н р э п э т ӄ и н _ т ы ԓ я м а _
наӄам нъэӄэгнитӄин ԓюур вай авынтыԓяма гыткаӄач ԓыгэгтонрапатгъэ ынраӄ	н а ӄ а м _ н ъ э ӄ э г н и т ӄ и н _ ԓ ю у р _ в а й _ а в ы н т ы ԓ я м а _ г ы т к а ӄ а ч _ ԓ ы г э г т о н р а п а т г ъ э _ ы н р а ӄ _
тиӈук нэнаԓвавӄэн наӄам рай ынкэчыку нинэԓгийгуткуйвыӄин	т и ӈ у к _ н э н а ԓ в а в ӄ э н _ н а ӄ а м _ р а й _ ы н к э ч ы к у _ н и н э ԓ г и й г у т к у й в ы ӄ и н _
гыткаԓгын рэӄэ ӄынвэр тиӈунин	г ы т к а ԓ г ы н _ р э ӄ э _ ӄ ы н в э р _ т и ӈ у н и н _
гыткаӄач эвын ынкы рээн йытонэн ыԓчыкойпы кайӈиӈын	г ы т к а ӄ а ч _ э в ы н _ ы н к ы _ р э э н _ й ы т о н э н _ ы ԓ ч ы к о й п ы _ к а й ӈ и ӈ ы н _
ԓыгэн ынӄэн гыткак рээн йытонэн ыныкит гитэнин	ԓ ы г э н _ ы н ӄ э н _ г ы т к а к _ р э э н _ й ы т о н э н _ ы н ы к и т _ г и т э н и н _
ӈэвысӄэтэ аны гэԓгигынтэвԓин ораываӄочеӈӄачагты наӄам ныԓгиӄуԓиԓьэтӄин аны	ӈ э в ы с ӄ э т э _ а н ы _ г э ԓ г и г ы н т э в ԓ и н _ о р а ы в а ӄ о ч е ӈ ӄ а ч а г т ы _ н а ӄ а м _ н ы ԓ г и ӄ у ԓ и ԓ ь э т ӄ и н _ а н ы _
вай ръанотайӈоон нэмэым ӈан	в а й _ р ъ а н о т а й ӈ о о н _ н э м э ы м _ ӈ а н _
нунрэпэтӄин тыԓяма наӄам	н у н р э п э т ӄ и н _ т ы ԓ я м а _ н а ӄ а м _
нъэӄэгнитӄин ԓюур вай	н ъ э ӄ э г н и т ӄ и н _ ԓ ю у р _ в а й _
авынтыԓяма гыткаӄач	а в ы н т ы ԓ я м а _ г ы т к а ӄ а ч _
ԓыгэгтонрапатгъэ ынраӄ тиӈук	ԓ ы г э г т о н р а п а т г ъ э _ ы н р а ӄ _ т и ӈ у к _
нэнаԓвавӄэн наӄам рай ынкэчыку	н э н а ԓ в а в ӄ э н _ н а ӄ а м _ р а й _ ы н к э ч ы к у _
нинэԓгийгуткуйвыӄин гыткаԓгын рэӄэ	н и н э ԓ г и й г у т к у й в ы ӄ и н _ г ы т к а ԓ г ы н _ р э ӄ э _
ӄынвэр тиӈунин	ӄ ы н в э р _ т и ӈ у н и н _
гыткаӄач	г ы т к а ӄ а ч _
эвын ынкы	э в ы н _ ы н к ы _
рээн	р э э н _
йытонэн ыԓчыкойпы кайӈиӈын ԓыгэн	й ы т о н э н _ ы ԓ ч ы к о й п ы _ к а й ӈ и ӈ ы н _ ԓ ы г э н _
ынӄэн гыткак	ы н ӄ э н _ г ы т к а к _
рээн йытонэн ыныкит гитэнин ӈэвысӄэтэ аны гэԓгигынтэвԓин ораываӄочеӈӄачагты	р э э н _ й ы т о н э н _ ы н ы к и т _ г и т э н и н _ ӈ э в ы с ӄ э т э _ а н ы _ г э ԓ г и г ы н т э в ԓ и н _ о р а ы в а ӄ о ч е ӈ ӄ а ч а г т ы _
наӄам ныԓгиӄуԓиԓьэтӄин аны вай ръанотайӈоон	н а ӄ а м _ н ы ԓ г и ӄ у ԓ и ԓ ь э т ӄ и н _ а н ы _ вай _ р ъ а н о т а й ӈ о о н _
ӄынвэр ӈан тэӈынпунӈитэвнин кэйӈын	ӄ ы н в э р _ ӈ а н _ т э ӈ ы н п у н ӈ и т э в н и н _ к э й ӈ ы н _
гынтавычгатгъэ	г ы н т а в ы ч г а т г ъ э _
кайӈиӈын рагтыгъат	к а й ӈ и ӈ ы н _ р а г т ы г ъ а т _
ытри ынӄо нэмэ эԓеръугъи тыԓванымтакачгыка	ы т р и _ ы н ӄ о _ н э м э _ э ԓ е р ъ у г ъ и _ т ы ԓ в а н ы м т а к а ч г ы к а _
ынръа гатваԓен	ы н р ъ а _ г а т в а ԓ е н _
ӄоныръым эвын ынӈин эмӄынгивик анымтакачгыка	ӄ о н ы р ъ ы м _ э в ы н _ ы н ӈ и н _ э м ӄ ы н г и в и к _ а н ы м т а к а ч г ы к а _
нытваӄэн вэгрэтэм	н ы т в а ӄ э н _ в э г р э т э м _
таӈымыԓьо вээм	т а ӈ ы м ы ԓ ь о _ в э э м _
ръиԓеръугъи кыткытръогъэ аноԓьатынвык	р ъ и ԓ е р ъ у г ъ и _ к ы т к ы т р ъ о г ъ э _ а н о ԓ ь а т ы н в ы к _
тыԓегъи вэгрэтэм	т ы ԓ е г ъ и _ в э г р э т э м _
ӄаанматыԓьатгъэ ынӄо имтиԓӄытгъи ӄааԓьатакватгъэ	ӄ а а н м а т ы ԓ ь а т г ъ э _ ы н ӄ о _ и м т и ԓ ӄ ы т г ъ и _ ӄ а а ԓ ь а т а к в а т г ъ э _
тыԓвамыргынан	т ы ԓ в а м ы р г ы н а н _
ӈэвъэнти пэԓянэнат наӄам	ӈ э в ъ э н т и _ п э ԓ я н э н а т _ н а ӄ а м _
ӄоԓ	ӄ о ԓ _
ӈэвъэн нанӄыԓьын нынныӈыттыӄинэт	ӈ э в ъ э н _ н а н ӄ ы ԓ ь ы н _ н ы н н ы ӈ ы т т ы ӄ и н э т _
эԓеӈит юур	э ԓ е ӈ и т _ ю у р _
рай ӄуԓиныкитэ	р а й _ ӄ у ԓ и н ы к и т э _
мэԓӄэпы ръэнут нывыргыргыръуӄин наӄам мэԓӄыткынык таӈвэнъым	м э ԓ ӄ э п ы _ р ъ э н у т _ н ы в ы р г ы р г ы р ъ у ӄ и н _ н а ӄ а м _ м э ԓ ӄ ы т к ы н ы к _ т а ӈ в э н ъ ы м _
мыгтэкичгыԓьын ынӄо эргатръогъэ нэгитэнэт тэкичгыт	м ы г т э к и ч г ы ԓ ь ы н _ ы н ӄ о _ э р г а т р ъ о г ъ э _ н э г и т э н э т _ т э к и ч г ы т _
аны эвын гэԓгинуйвыԓинэт	а н ы _ э в ы н _ г э ԓ г и н у й в ы ԓ и н э т _
тэкичгыт ынӄо нэмэ	т э к и ч г ы т _ ы н ӄ о _ н э м э _
йыԓӄэтгъэт ӄуԓивуԓӄытвик кыеквъэт	й ы ԓ ӄ э т г ъ э т _ ӄ у ԓ и в у ԓ ӄ ы т в и к _ к ы е к в ъ э т _
эвын тэӈуйӈэ	э в ы н _ т э ӈ у й ӈ э _
тэкичгыт миԓӄык таӈымыԓьо гэнуйвыԓинэт аны ныԓгайыԓгавӄэнат ӄуԓиныкитэ	т э к и ч г ы т _ м и ԓ ӄ ы к _ т а ӈ ы м ы ԓ ь о _ г э н у й в ы ԓ и н э т _ а н ы _ н ы ԓ г а й ы ԓ г а в ӄ э н а т _ ӄ у ԓ и н ы к и т э _
яракэн рэнмырэм	я р а к э н _ р э н м ы р э м _
натъайытчагъан	н а т ъ а й ы т ч а г ъ а н _
ԓыгэн нынӄъэӄыръувӄин ӄытԓыги	ԓ ы г э н _ н ы н ӄ ъ э ӄ ы р ъ у в ӄ и н _ ӄ ы т ԓ ы г и _
ынӄэнат кэйӈыт	ы н ӄ э н а т _ к э й ӈ ы т _
амайыԓгаым ванэван нырэӄынэт ӈэвысӄэтти ӄынвэр ӄоԓетъыԓё тэӈэтэкичгыкэ нъэԓгъэт таӈымыԓьо гагтоԓенат кэйӈэ	а м а й ы ԓ г а ы м _ в а н э в а н _ н ы р э ӄ ы н э т _ ӈ э в ы с ӄ э т т и _ ӄ ы н в э р _ ӄ о ԓ е т ъ ы ԓ ё _ т э ӈ э т э к и ч г ы к э _ н ъ э ԓ г ъ э т _ т а ӈ ы м ы ԓ ь о _ г а г т о ԓ е н а т _ к э й ӈ э _
ӄуԓивуԓӄытвик энарэрыԓьатыӈӈогъат рэноԓгыгэӈгыпы ԓыгэн	ӄ у ԓ и в у ԓ ӄ ы т в и к _ э н а р э р ы ԓ ь а т ы ӈ ӈ о г ъ а т _ р э н о ԓ г ы г э ӈ г ы п ы _ ԓ ы г э н _
ӄун	ӄ у н _
ныԓгивэгыткуԓьэтӄинэт	н ы ԓ г и в э г ы т к у ԓ ь э т ӄ и н э т _
уйӈэ нытваӄэнат	у й ӈ э _ н ы т в а ӄ э н а т _
ԓюур	ԓ ю у р _
ӄотԓяйӈын ёрогты	ӄ о т ԓ я й ӈ ы н _ ё р о г т ы _
кытгъи ерочыкон нэнчимиръэвын нанӄыԓьын нэпиригъэн ынӄо таӈавынӄоԓеԓьыръогты	к ы т г ъ и _ е р о ч ы к о н _ н э н ч и м и р ъ э в ы н _ н а н ӄ ы ԓ ь ы н _ н э п и р и г ъ э н _ ы н ӄ о _ т а ӈ а в ы н ӄ о ԓ е ԓ ь ы р ъ о г т ы _
нанынтоӈатын ӈаргыногты эргатръогъэ таӈамынан нъэԓгъи чимгъугъи ӈэвысӄэт тэйкынин тытԓык ваны варэсӄыткынык	н а н ы н т о ӈ а т ы н _ ӈ а р г ы н о г т ы _ э р г а т р ъ о г ъ э _ т а ӈ а м ы н а н _ н ъ э ԓ г ъ и _ ч и м г ъ у г ъ и _ ӈ э в ы с ӄ э т _ т э й к ы н и н _ т ы т ԓ ы к _ в а н ы _ в а р э с ӄ ы т к ы н ы к _
румэкэвъюунинэт уунъыкэнъут	р у м э к э в ъ ю у н и н э т _ у у н ъ ы к э н ъ у т _
ӈэнку натчытваӄэн	ӈ э н к у _ н а т ч ы т в а ӄ э н _
вуԓӄытвигъи нэмэ ԓыгэн ярачыкогты	в у ԓ ӄ ы т в и г ъ и _ н э м э _ ԓ ы г э н _ я р а ч ы к о г т ы _
авынгачагъат ытԓёным	а в ы н г а ч а г ъ а т _ ы т ԓ ё н ы м _
ӈоон гыргоԓ	ӈ о о н _ г ы р г о ԓ _
нывакъотваӄэн нэмэ	н ы в а к ъ о т в а ӄ э н _ н э м э _
моогъат энарэрыԓьатык	м о о г ъ а т _ э н а р э р ы ԓ ь а т ы к _
инэԓьук ԓываквъат ӄоԓ	и н э ԓ ь у к _ ԓ ы в а к в ъ а т _ ӄ о ԓ _
ӈытоӈӈой ӈытосӄэвыԓьын	ӈ ы т о ӈ ӈ о й _ ӈ ы т о с ӄ э в ы ԓ ь ы н _
ӈэвысӄэтэ ӈыԓенӈыԓетэ	ӈ э в ы с ӄ э т э _ ӈ ы ԓ е н ӈ ы ԓ е т э _
инэгнэрэннин ӄаптэткынык иргъи ӈыԓенӈыԓет ԓыгэным эвыр ынкэӄэй ӈыԓетръугъи кайӈиӈын авынгынтавыԓьатэты йытрыкымгытръогъэ	и н э г н э р э н н и н _ ӄ а п т э т к ы н ы к _ и р г ъ и _ ӈ ы ԓ е н ӈ ы ԓ е т _ ԓ ы г э н ы м _ э в ы р _ ы н к э ӄ э й _ ӈ ы ԓ е т р ъ у г ъ и _ к а й ӈ и ӈ ы н _ а в ы н г ы н т а в ы ԓ ь а т э т ы _ й ы т р ы к ы м г ы т р ъ о г ъ э _
ынӄоым гапэӄэттатԓен ӄотԓяйӈаым таӈгэмо нинэԓгыӄин	ы н ӄ о ы м _ г а п э ӄ э т т а т ԓ е н _ ӄ о т ԓ я й ӈ а ы м _ т а ӈ г э м о _ н и н э ԓ г ы ӄ и н _
тыԓвыԓьын ынин	т ы ԓ в ы ԓ ь ы н _ ы н и н _
томгиӈын	т о м г и ӈ ы н _
пԓыткугъи энарэрыԓьатык ӈытоӈӈой	п ԓ ы т к у г ъ и _ э н а р э р ы ԓ ь а т ы к _ ӈ ы т о ӈ ӈ о й _
кайӈиӈын нэмэ рэрэннин йынйынчыӈын	к а й ӈ и ӈ ы н _ н э м э _ р э р э н н и н _ й ы н й ы н ч ы ӈ ы н _
рыԓвэтъюунин ӈоонко	р ы ԓ в э т ъ ю у н и н _ ӈ о о н к о _
пэӄэттатгъэ	п э ӄ э т т а т г ъ э _
уйӈэ нъэԓгъи	у й ӈ э _ н ъ э ԓ г ъ и _
эгытԓикэйӈыкэ ӄоԓетъыԓё пыкиргъи ӄааԓьатыԓьын	э г ы т ԓ и к э й ӈ ы к э _ ӄ о ԓ е т ъ ы ԓ ё _ п ы к и р г ъ и _ ӄ а а ԓ ь а т ы ԓ ь ы н _
ӈэвъэнэ ԓыгэнитык	ӈ э в ъ э н э _ ԓ ы г э н и т ы к _
ԓыгъэйӈэчьивнин раӈӈытайым	ԓ ы г ъ э й ӈ э ч ь и в н и н _ р а ӈ ӈ ы т а й ы м _
эми ӄоԓ ӈэвысӄэт энмэч	э м и _ ӄ о ԓ _ ӈ э в ы с ӄ э т _ э н м э ч _
ымыӈ гым вэнъыгну тыегтэԓык ԓыгэн аны	ы м ы ӈ _ г ы м _ в э н ъ ы г н у _ т ы е г т э ԓ ы к _ ԓ ы г э н _ а н ы _
гыт мурык	г ы т _ м у р ы к _
аӈъачгыргэгыт нымытвак	а ӈ ъ а ч г ы р г э г ы т _ н ы м ы т в а к _
нэмэ нымытваӈӈогъат рымагтэты гытгаръогъэ яԓгытгъат рэвиквъэт	н э м э _ н ы м ы т в а ӈ ӈ о г ъ а т _ р ы м а г т э т ы _ г ы т г а р ъ о г ъ э _ я ԓ г ы т г ъ а т _ р э в и к в ъ э т _
йичьэннупык ӄача ынкы	й и ч ь э н н у п ы к _ ӄ а ч а _ ы н к ы _
ынраӄ кэтэм гатваԓен пэнинэԓьын ӄԓявыԓ чама ӄэгъюргын	ы н р а ӄ _ к э т э м _ г а т в а ԓ е н _ п э н и н э ԓ ь ы н _ ӄ ԓ я в ы ԓ _ ч а м а _ ӄ э г ъ ю р г ы н _
тараӈыпԓыткогъат умуттуут пиринин ӄыԓявоԓя ынкъам	т а р а ӈ ы п ԓ ы т к о г ъ а т _ у м у т т у у т _ п и р и н и н _ ӄ ы ԓ я в о ԓ я _ ы н к ъ а м _
йъонэн	й ъ о н э н _
въиԓьын ынкы ытръэч нытваӄэн пыгԓыԓявыт ынӄэн кыпԓынэн рычимиръэвнин ынӄо рагтыгъэ вуԓӄытвигъи	в ъ и ԓ ь ы н _ ы н к ы _ ы т р ъ э ч _ н ы т в а ӄ э н _ п ы г ԓ ы ԓ я в ы т _ ы н ӄ э н _ к ы п ԓ ы н э н _ р ы ч и м и р ъ э в н и н _ ы н ӄ о _ р а г т ы г ъ э _ в у ԓ ӄ ы т в и г ъ и _
ривыԓӄытгьи наӄамым ӈэԓвыԓ ярак камԓеԓы нытваӄэн ӈэвысӄэт амынан ярак пэԓятгъэ айвэчгыръогъэ ӈэвысӄэт ванэван ныйыԓӄэтын ԓюур	р и в ы ԓ ӄ ы т г ь и _ н а ӄ а м ы м _ ӈ э ԓ в ы ԓ _ я р а к _ к а м ԓ е ԓ ы _ н ы т в а ӄ э н _ ӈ э в ы с ӄ э т _ а м ы н а н _ я р а к _ п э ԓ я т г ъ э _ а й в э ч г ы р ъ о г ъ э _ ӈ э в ы с ӄ э т _ в а н э в а н _ н ы й ы ԓ ӄ э т ы н _ ԓ ю у р _
рай ръэнут выргыргэтгъи тытԓыӄачайпы ӈэвысӄэт паԓёмтэԓгъэ нэмэ рай выргыргыръугьи яраттатгъэ ӄытԓыги рыногыргэпы	р а й _ р ъ э н у т _ в ы р г ы р г э т г ъ и _ т ы т ԓ ы ӄ а ч а й п ы _ ӈ э в ы с ӄ э т _ п а ԓ ё м т э ԓ г ъ э _ н э м э _ р а й _ в ы р г ы р г ы р ъ у г ь и _ я р а т т а т г ъ э _ ӄ ы т ԓ ы г и _ р ы н о г ы р г э п ы _
ԓевыт ръыԓинин ынӄо нывэтгавӄэн микынэ гымнин ԓевыт гэнчимиръэвԓин иԓпыгитэ	ԓ е в ы т _ р ъ ы ԓ и н и н _ ы н ӄ о _ н ы в э т г а в ӄ э н _ м и к ы н э _ г ы м н и н _ ԓ е в ы т _ г э н ч и м и р ъ э в ԓ и н _ и ԓ п ы г и т э _
ръыԓинин увик ээ вынэ авъеткынка ӄытватык эрэтгъи рыногыргыткынгыпы	р ъ ы ԓ и н и н _ у в и к _ э э _ в ы н э _ а в ъ е т к ы н к а _ ӄ ы т в а т ы к _ э р э т г ъ и _ р ы н о г ы р г ы т к ы н г ы п ы _
ынраӄ аграткынык иргъи эми авынраԓьын ээ	ы н р а ӄ _ а г р а т к ы н ы к _ и р г ъ и _ э м и _ а в ы н р а ԓ ь ы н _ э э _
уйӈэээ ээ уйӈэээ чьовыргын	у й ӈ э э э _ э э _ у й ӈ э э э _ ч ь о в ы р г ы н _
рывэнтэннин ӈэвысӄэт гэԓгичеӈыттэтԓин рыпэт гэтэӈуԓвэвԓин ыннэнпэнинэк пынԓёԓьатыӈӈогъэ каԓьайӈын микынэӈ гэнчимэвԓин ээ	р ы в э н т э н н и н _ ӈ э в ы с ӄ э т _ г э ԓ г и ч е ӈ ы т т э т ԓ и н _ р ы п э т _ г э т э ӈ у ԓ в э в ԓ и н _ ы н н э н п э н и н э к _ п ы н ԓ ё ԓ ь а т ы ӈ ӈ о г ъ э _ к а ԓ ь а й ӈ ы н _ м и к ы н э ӈ _ г э н ч и м э в ԓ и н _ э э _
вынэ ӄымӈыԓтэԓыркын ӈэвысӄэт	в ы н э _ ӄ ы м ӈ ы ԓ т э ԓ ы р к ы н _ ӈ э в ы с ӄ э т _
моогъэ вэтгавык гымык ывэӄучитэ ынӈин рыннин миӈкыри ӄун ԓыгиӄэгъюргын	м о о г ъ э _ в э т г а в ы к _ г ы м ы к _ ы в э ӄ у ч и т э _ ы н ӈ и н _ р ы н н и н _ м и ӈ к ы р и _ ӄ у н _ ԓ ы г и ӄ э г ъ ю р г ы н _
гымнин ывэӄуч чама ԓыгъэткиӈ ԓыгэн	г ы м н и н _ ы в э ӄ у ч _ ч а м а _ ԓ ы г ъ э т к и ӈ _ ԓ ы г э н _
ӄун эӄэгкутъюунин каԓьайӈын	ӄ у н _ э ӄ э г к у т ъ ю у н и н _ к а ԓ ь а й ӈ ы н _
иквъи мурык рэтэӈычьэтгъэ ынӄэн	и к в ъ и _ м у р ы к _ р э т э ӈ ы ч ь э т г ъ э _ ы н ӄ э н _
ӄырымэн кэԓы въиԓьын пэнинэԓьын	ӄ ы р ы м э н _ к э ԓ ы _ в ъ и ԓ ь ы н _ п э н и н э ԓ ь ы н _
ынӄо рынтоӈаннэн эргатык	ы н ӄ о _ р ы н т о ӈ а н н э н _ э р г а т ы к _
эвын эргыръоӈӈок ӄԓявыԓ рагтыгъэ амын	э в ы н _ э р г ы р ъ о ӈ ӈ о к _ ӄ ԓ я в ы ԓ _ р а г т ы г ъ э _ а м ы н _
эвын уйӈэ ярак ӈэвысӄэт	э в ы н _ у й ӈ э _ я р а к _ ӈ э в ы с ӄ э т _
ӄырирнин танԓымынӄоԓьук	ӄ ы р и р н и н _ т а н ԓ ы м ы н ӄ о ԓ ь у к _
ԓывавнэн ынӄо маёԓгыткынэты ӄытгъи 	ԓ ы в а в н э н _ ы н ӄ о _ м а ё ԓ г ы т к ы н э т ы _ ӄ ы т г ъ и _ _
эвын ӈэнку нарычгытваӄэн гитэнин эвын гэвъиԓин ԓюӈпиритэ ымыӈ рыннин	э в ы н _ ӈ э н к у _ н а р ы ч г ы т в а ӄ э н _ г и т э н и н _ э в ы н _ г э в ъ и ԓ и н _ ԓ ю ӈ п и р и т э _ ы м ы ӈ _ р ы н н и н _
ԓыгэн рагтыгъэ кытгынта рырэйвэвнин яраӈы	ԓ ы г э н _ р а г т ы г ъ э _ к ы т г ы н т а _ р ы р э й в э в н и н _ я р а ӈ ы _
ԓыгэӄыԓпэ ынкъам яԓгытгъэ нымгутыԓеӄин гэԓгуврэмгутыԓеԓин рэвиквъи	ԓ ы г э ӄ ы ԓ п э _ ы н к ъ а м _ я ԓ г ы т г ъ э _ н ы м г у т ы ԓ е ӄ и н _ г э ԓ г у в р э м г у т ы ԓ е ԓ и н _ р э в и к в ъ и _
вытку воԓӄытвэма тараӈгъэ	в ы т к у _ в о ԓ ӄ ы т в э м а _ т а р а ӈ г ъ э _
ԓыгэӄыԓпэ ԓыгэн	ԓ ы г э ӄ ы ԓ п э _ ԓ ы г э н _
апԓёратвака рай	а п ԓ ё р а т в а к а _ р а й _
ӄоԓейӈын	ӄ о ԓ е й ӈ ы н _
мооръэтыӈӄачайпы	м о о р ъ э т ы ӈ ӄ а ч а й п ы _
вэгрэтээм эмитԓёнайгоот коԓё наӄам	в э г р э т э э м _ э м и т ԓ ё н а й г о о т _ к о ԓ ё _ н а ӄ а м _
отконаӈайӈыт нынрыӄинэт пыкэрычгатгъат кынмаԓ ԓыгэн ынкы нанмын вэгрэтэм ынаным иам ныпичгыӄин с энмэн ӄоԓ	о т к о н а ӈ а й ӈ ы т _ н ы н р ы ӄ и н э т _ п ы к э р ы ч г а т г ъ а т _ к ы н м а ԓ _ ԓ ы г э н _ ы н к ы _ н а н м ы н _ в э г р э т э м _ ы н а н ы м _ и а м _ н ы п и ч г ы ӄ и н _ с _ э н м э н _ ӄ о ԓ _
имъэԓиԓьин ӄԓявыԓ амыным нивӄин нивӄинэт энмэн	и м ъ э ԓ и ԓ ь и н _ ӄ ԓ я в ы ԓ _ а м ы н ы м _ н и в ӄ и н _ н и в ӄ и н э т _ э н м э н _
ынӄэн имъэԓиԓьырык гатваԓен тэԓенъеп	ы н ӄ э н _ и м ъ э ԓ и ԓ ь ы р ы к _ г а т в а ԓ е н _ т э ԓ е н ъ е п _
энмэн ӄоԓ имъэԓиԓьин ӄԓявыԓ	э н м э н _ ӄ о ԓ _ и м ъ э ԓ и ԓ ь и н _ ӄ ԓ я в ы ԓ _
амыным нивӄин выквыԓгын ӈутку ниниԓгэтӄин ӈиԓгэ ынкъам	а м ы н ы м _ н и в ӄ и н _ в ы к в ы ԓ г ы н _ ӈ у т к у _ н и н и ԓ г э т ӄ и н _ ӈ и ԓ г э _ ы н к ъ а м _
ныриӈэӄин ыяа гыргоԓягты риӈэгъи ӄоԓетъыԓё коԓё ёо гэпкитԓин айгынԓейпы наӄам ынкэкин ымыԓьо гивиниԓинэт 	н ы р и ӈ э ӄ и н _ ы я а _ г ы р г о ԓ я г т ы _ р и ӈ э г ъ и _ ӄ о ԓ е т ъ ы ԓ ё _ к о ԓ ё _ ё о _ г э п к и т ԓ и н _ а й г ы н ԓ е й п ы _ н а ӄ а м _ ы н к э к и н _ ы м ы ԓ ь о _ г и в и н и ԓ и н э т _ _
гэнԓьэтэтԓинэт гэԓыткынык	г э н ԓ ь э т э т ԓ и н э т _ г э ԓ ы т к ы н ы к _
ымыԓьо имъэԓиԓьыт ӄԓявыԓтэ ынӄо	ы м ы ԓ ь о _ и м ъ э ԓ и ԓ ь ы т _ ӄ ԓ я в ы ԓ т э _ ы н ӄ о _
ӈырача кивкы ӄԓявыԓен нэнэны гивԓин эптэ	ӈ ы р а ч а _ к и в к ы _ ӄ ԓ я в ы ԓ е н _ н э н э н ы _ г и в ԓ и н _ э п т э _
гым ытԓыгмиԓ мыриӈэгъэк ытԓьата нинивӄин ынӄо гэвэнэчаԓен имъэԓиԓьын ӈинӄэй ынӄэн тъэче киквъи ёатык	г ы м _ ы т ԓ ы г м и ԓ _ м ы р и ӈ э г ъ э к _ ы т ԓ ь а т а _ н и н и в ӄ и н _ ы н ӄ о _ г э в э н э ч а ԓ е н _ и м ъ э ԓ и ԓ ь ы н _ ӈ и н ӄ э й _ ы н ӄ э н _ т ъ э ч е _ к и к в ъ и _ ё а т ы к _
ярак ынӄоры ынӄэн ӈинӄэй	я р а к _ ы н ӄ о р ы _ ы н ӄ э н _ ӈ и н ӄ э й _
иквъи амын амморгынан мытынъэԓмык мэӈӄо мури	и к в ъ и _ а м ы н _ а м м о р г ы н а н _ м ы т ы н ъ э ԓ м ы к _ м э ӈ ӄ о _ м у р и _
мытраӄамэтва ԓымӈэ иквъи ытԓьата ивнин ӈинӄэй	м ы т р а ӄ а м э т в а _ ԓ ы м ӈ э _ и к в ъ и _ ы т ԓ ь а т а _ и в н и н _ ӈ и н ӄ э й _
гивԓин ытԓьата ивнин эккэтэ ивнин	г и в ԓ и н _ ы т ԓ ь а т а _ и в н и н _ э к к э т э _ ивнин _
кита имъэԓиԓьын мыёпатынат аӈӄата рыԓьататъёттэ ытԓьата ивнин	к и т а _ и м ъ э ԓ и ԓ ь ы н _ м ы ё п а т ы н а т _ а ӈ ӄ а т а _ р ы ԓ ь а т а т ъ ё т т э _ ы т ԓ ь а т а _ и в н и н _
ӈинӄэе ивнин наӄам ёо коԓё ӄынвэр ытԓьата ивнин ӈинӄэй	ӈ и н ӄ э е _ ивнин _ н а ӄ а м _ ё о _ к о ԓ ё _ ӄ ы н в э р _ ы т ԓ ь а т а _ и в н и н _ ӈ и н ӄ э й _
иквъи эвыр трэԓьуӈын эӄыԓпэ трэетгъэ ымыԓьо	и к в ъ и _ э в ы р _ т р э ԓ ь у ӈ ы н _ э ӄ ы ԓ п э _ т р э е т г ъ э _ ы м ы ԓ ь о _
имъэԓиԓьыт гумэкэтԓинэт нивӄинэт эквэтгъи коԓё ёо авынтыԓягты	и м ъ э ԓ и ԓ ь ы т _ г у м э к э т ԓ и н э т _ н и в ӄ и н э т _ э к в э т г ъ и _ к о ԓ ё _ ё о _ а в ы н т ы ԓ я г т ы _
ӄытгъи ӄоԓ	ӄ ы т г ъ и _ ӄ о ԓ _
ԓьунин ӄԓявыԓ нэмыӄэй	ԓ ь у н и н _ ӄ ԓ я в ы ԓ _ н э м ы ӄ э й _
риӈэԓьын ивнин ԓюур иквъи гытым нырэӄигыт имъэԓиԓьэ	р и ӈ э ԓ ь ы н _ и в н и н _ ԓ ю у р _ и к в ъ и _ г ы т ы м _ н ы р э ӄ и г ы т _ и м ъ э ԓ и ԓ ь э _
ивнин уӈииԓьэ ивнин	и в н и н _ у ӈ и и ԓ ь э _ и в н и н _
имъэԓиԓьэ ивнин уӈииԓьэ	и м ъ э ԓ и ԓ ь э _ и в н и н _ у ӈ и и ԓ ь э _
ивнин ынӄоры ынӈин	и в н и н _ ы н ӄ о р ы _ ы н ӈ и н _
вэтгавма ԓюур уӈииԓьэ кыпԓынэн аԓыгатгата имъэԓиԓьын	в э т г а в м а _ ԓ ю у р _ у ӈ и и ԓ ь э _ к ы п ԓ ы н э н _ а ԓ ы г а т г а т а _ и м ъ э ԓ и ԓ ь ы н _
ԓевыт гэчвиԓин имъэԓиԓьын эрэтгьи гэԓыткынык иргъи уйӈэ эриӈэкэ нъэԓгъи	ԓ е в ы т _ г э ч в и ԓ и н _ и м ъ э ԓ и ԓ ь ы н _ э р э т г ь и _ г э ԓ ы т к ы н ы к _ и р г ъ и _ у й ӈ э _ э р и ӈ э к э _ н ъ э ԓ г ъ и _
ынӄоры уӈииԓьэ аԓыгаттэ тиӈунин эйминнин ынӄо нымэԓьэв	ы н ӄ о р ы _ у ӈ и и ԓ ь э _ а ԓ ы г а т т э _ т и ӈ у н и н _ э й м и н н и н _ ы н ӄ о _ н ы м э ԓ ь э в _
нъыркыпԓынэн	н ъ ы р к ы п ԓ ы н э н _
имъэԓиԓьын риӈэгъи выква иннин уӈииԓьын 	и м ъ э ԓ и ԓ ь ы н _ р и ӈ э г ъ и _ в ы к в а _ и н н и н _ у ӈ и и ԓ ь ы н _ _
рымутԓытъэвнин	р ы м у т ԓ ы т ъ э в н и н _
уӈииԓьын	у ӈ и и ԓ ь ы н _
эрэтгъи гэԓыткынык итгъи мъэԓиԓьэ выквыԓгын тиӈунин	э р э т г ъ и _ г э ԓ ы т к ы н ы к _ и т г ъ и _ м ъ э ԓ и ԓ ь э _ в ы к в ы ԓ г ы н _ т и ӈ у н и н _
иӈӄун нъынчимэвнин ԓевыт	и ӈ ӄ у н _ н ъ ы н ч и м э в н и н _ ԓ е в ы т _
иӈӄун нъывъигъэн	и ӈ ӄ у н _ н ъ ы в ъ и г ъ э н _
эчги тиӈунин имъэԓиԓьэ аԓыгаттэ	э ч г и _ т и ӈ у н и н _ и м ъ э ԓ и ԓ ь э _ а ԓ ы г а т т э _
ԓюур рыркайӈын пиврэгъи эчги	ԓ ю у р _ р ы р к а й ӈ ы н _ п и в р э г ъ и _ э ч г и _
ынӈот рыннин эчги тымыркынэнрыркайӈа	ы н ӈ о т _ р ы н н и н _ э ч г и _ т ы м ы р к ы н э н р ы р к а й ӈ а _
ранӈавнэн уӈииԓьын уйӈэ ръэнут	р а н ӈ а в н э н _ у ӈ и и ԓ ь ы н _ у й ӈ э _ р ъ э н у т _
гэԓьуԓин ганӈатԓен ынӄоры имъэԓиԓьын рагтыгъэ пыкирык	г э ԓ ь у ԓ и н _ г а н ӈ а т ԓ е н _ ы н ӄ о р ы _ и м ъ э ԓ и ԓ ь ы н _ р а г т ы г ъ э _ п ы к и р ы к _
эвын гэмутԓыԓин никвъэн тумгэ ынӄэйына	э в ы н _ г э м у т ԓ ы ԓ и н _ н и к в ъ э н _ т у м г э _ ы н ӄ э й ы н а _
гэнъаԓыгатгапԓен чит энмэн уӈииԓьыт гэнԓьэтэтъюуԓинэт	г э н ъ а ԓ ы г а т г а п ԓ е н _ ч и т _ э н м э н _ у ӈ и и ԓ ь ы т _ г э н ԓ ь э т э т ъ ю у ԓ и н э т _
нэмыӄэй энарэрыԓьа гинэԓьуԓин	н э м ы ӄ э й _ э н а р э р ы ԓ ь а _ г и н э ԓ ь у ԓ и н _
гэнъаԓыгатгапԓен паагъэ риӈэк эԓеръугъи панэна эмэԓевкыԓьин	г э н ъ а ԓ ы г а т г а п ԓ е н _ п а а г ъ э _ р и ӈ э к _ э ԓ е р ъ у г ъ и _ п а н э н а _ э м э ԓ е в к ы ԓ ь и н _
ԓевыт иквъи эптэ гым мычавчывантагъак	ԓ е в ы т _ и к в ъ и _ э п т э _ г ы м _ м ы ч а в ч ы в а н т а г ъ а к _
ԓьораӄоймагты имъэԓиԓьыт ӄытгъэт пыкиргъэт ԓьораӄоймак эвын	ԓ ь о р а ӄ о й м а г т ы _ и м ъ э ԓ и ԓ ь ы т _ ӄ ы т г ъ э т _ п ы к и р г ъ э т _ ԓ ь о р а ӄ о й м а к _ э в ы н _
уӈииԓьыт ынкы нэмыӄэй	у ӈ и и ԓ ь ы т _ ы н к ы _ н э м ы ӄ э й _
атынвыԓьын ынкы ӄытԓыги ынин	а т ы н в ы ԓ ь ы н _ ы н к ы _ ӄ ы т ԓ ы г и _ ы н и н _
атынватъё ымыӈ гачавчывантаԓен	а т ы н в а т ъ ё _ ы м ы ӈ _ г а ч а в ч ы в а н т а ԓ е н _
ӈирэче кивкы ӄытгъи	ӈ и р э ч е _ к и в к ы _ ӄ ы т г ъ и _
уӈииԓьын ивнин имъэԓиԓьэ ивнин	у ӈ и и ԓ ь ы н _ и в н и н _ и м ъ э ԓ и ԓ ь э _ и в н и н _
гым эквырга тымэйӈэтык ынӈин ваԓьэгым уӈииԓьэ нинивӄин	г ы м _ э к в ы р г а _ т ы м э й ӈ э т ы к _ ы н ӈ и н _ в а ԓ ь э г ы м _ у ӈ и и ԓ ь э _ н и н и в ӄ и н _
ӄэйвэ мэԓгыт тыԓьугыт	ӄ э й в э _ м э ԓ г ы т _ т ы ԓ ь у г ы т _
ԓьэԓеӈкы риӈэк имъэԓиԓьэ	ԓ ь э ԓ е ӈ к ы _ р и ӈ э к _ и м ъ э ԓ и ԓ ь э _
нинивӄин эты эԓвэԓьин	н и н и в ӄ и н _ э т ы _ э ԓ в э ԓ ь и н _
уӈииԓьэ тумгыт нинивӄинэт	у ӈ и и ԓ ь э _ т у м г ы т _ н и н и в ӄ и н э т _
тумгэ нивӄин ӄэгԓынангэт	т у м г э _ н и в ӄ и н _ ӄ э г ԓ ы н а н г э т _
ԓёӈынма рагтыгъат имъэԓиԓьыт пыкиргъэт румэкэвнин	ԓ ё ӈ ы н м а _ р а г т ы г ъ а т _ и м ъ э ԓ и ԓ ь ы т _ п ы к и р г ъ э т _ р у м э к э в н и н _
имъэԓиԓьыт ымыԓьо ивнинэт ӄоԓ имъэԓиԓьын иквъи экык иквъи ытԓьата	и м ъ э ԓ и ԓ ь ы т _ ы м ы ԓ ь о _ и в н и н э т _ ӄ о ԓ _ и м ъ э ԓ и ԓ ь ы н _ и к в ъ и _ э к ы к _ и к в ъ и _ ы т ԓ ь а т а _
ивнин вэчьым гыт ымыӈ рэӄысӄычевыӈ ӄырым ӄыетги	и в н и н _ в э ч ь ы м _ г ы т _ ы м ы ӈ _ р э ӄ ы с ӄ ы ч е в ы ӈ _ ӄ ы р ы м _ ӄ ы е т г и _
ӄынвэр ынӄэн эккэӄэй никвъэн имъэԓиԓьэ нэмэ экык риӈэгъи нэмэ выквыԓгын	ӄ ы н в э р _ ы н ӄ э н _ э к к э ӄ э й _ н и к в ъ э н _ и м ъ э ԓ и ԓ ь э _ н э м э _ э к ы к _ р и ӈ э г ъ и _ н э м э _ в ы к в ы ԓ г ы н _
пэнин патгыргыԓгын ԓьунин гыргоԓ ԓыгэн ынкэгйит гатааԓен	п э н и н _ п а т г ы р г ы ԓ г ы н _ ԓ ь у н и н _ г ы р г о ԓ _ ԓ ы г э н _ ы н к э г й и т _ г а т а а ԓ е н _
пинтыӄэтгъи гыргоԓ эвын	п и н т ы ӄ э т г ъ и _ г ы р г о ԓ _ э в ы н _
ынкы ԓьунин ӈагчыӈын никвыӄин	ы н к ы _ ԓ ь у н и н _ ӈ а г ч ы ӈ ы н _ н и к в ы ӄ и н _
ынкэгйит ныԓеӄин иквъи миӈкэтэ гыргоча мытаан юур никвъэн	ы н к э г й и т _ н ы ԓ е ӄ и н _ и к в ъ и _ м и ӈ к э т э _ г ы р г о ч а _ м ы т а а н _ ю у р _ н и к в ъ э н _
ыныкит ынкы рэймэвнин	ы н ы к и т _ ы н к ы _ р э й м э в н и н _
эвын ытԓыгын ынин ынкы варкын кымъыйӈа	э в ы н _ ы т ԓ ы г ы н _ ы н и н _ ы н к ы _ в а р к ы н _ к ы м ъ ы й ӈ а _
гэпириԓин мынга гытката эккэтэ ԓьунин ытԓыгын	г э п и р и ԓ и н _ м ы н г а _ г ы т к а т а _ э к к э т э _ ԓ ь у н и н _ ы т ԓ ы г ы н _
гаԓягъэ ивнин ивнин эккэтэ ивнин тыԓӄыриргыт ытԓыгэ ивнин ӈотӄэн	г а ԓ я г ъ э _ и в н и н _ и в н и н _ э к к э т э _ ивнин _ т ы ԓ ӄ ы р и р г ы т _ ы т ԓ ы г э _ и в н и н _ ӈ о т ӄ э н _
кымъыԓгын нымэйыӈӄин коԓё гыткат	к ы м ъ ы ԓ г ы н _ н ы м э й ы ӈ ӄ и н _ к о ԓ ё _ г ы т к а т _
нымкыӄинэт нивԓыӄинэт	н ы м к ы ӄ и н э т _ н и в ԓ ы ӄ и н э т _
вайым гым ымыԓьо вагыԓгын гинэпԓин чамъам трэриӈэгъэ ӄонпыӈ гым ӈутку тынъэԓык эккэтэ ивнин тиӈунин	в а й ы м _ г ы м _ ы м ы ԓ ь о _ в а г ы ԓ г ы н _ г и н э п ԓ и н _ ч а м ъ а м _ т р э р и ӈ э г ъ э _ ӄ о н п ы ӈ _ г ы м _ ӈ у т к у _ т ы н ъ э ԓ ы к _ э к к э т э _ и в н и н _ т и ӈ у н и н _
выквыԓгын выквыԓгын ринтынин	в ы к в ы ԓ г ы н _ в ы к в ы ԓ г ы н _ р и н т ы н и н _
кымъыԓгын кымъукэтгъи ытԓыгын пынԓёнэн	к ы м ъ ы ԓ г ы н _ к ы м ъ у к э т г ъ и _ ы т ԓ ы г ы н _ п ы н ԓ ё н э н _
ивнин ытԓыгэ	и в н и н _ ы т ԓ ы г э _
нэмэ	н э м э _
тиӈунин нэмэ ринтынин нэмэ	т и ӈ у н и н _ н э м э _ р и н т ы н и н _ н э м э _
кымъукэтгъи гынмыԓкинэк майыӈкы	к ы м ъ у к э т г ъ и _ г ы н м ы ԓ к и н э к _ м а й ы ӈ к ы _
ытԓыгын пынԓёнэн нэмэ	ы т ԓ ы г ы н _ п ы н ԓ ё н э н _ н э м э _
тиӈунин ӈыроӄавкы ринтынин кымъыԓгын	т и ӈ у н и н _ ӈ ы р о ӄ а в к ы _ р и н т ы н и н _ к ы м ъ ы ԓ г ы н _
ымыԓьэты	ы м ы ԓ ь э т ы _
ӄынур тымнэн гыткат	ӄ ы н у р _ т ы м н э н _ г ы т к а т _
янра ымыӈ ынин	я н р а _ ы м ы ӈ _ ы н и н _
ытԓыгын тымнэн	ы т ԓ ы г ы н _ т ы м н э н _
ынӄо груԓмыгъи	ы н ӄ о _ г р у ԓ м ы г ъ и _
ытԓыгин инничгын ԓьунин	ы т ԓ ы г и н _ и н н и ч г ы н _ ԓ ь у н и н _
ынӄэн эйминнин иквъи	ы н ӄ э н _ э й м и н н и н _ и к в ъ и _
вэԓерым ытԓыгын тыԓьугъэн ӈотӄэн	в э ԓ е р ы м _ ы т ԓ ы г ы н _ т ы ԓ ь у г ъ э н _ ӈ о т ӄ э н _
эмэԓкэ ытԓыгын тынрагтатын ӈэвъэнэ рэԓьугнин ӄэгԓынангэт агтыгъэ пыкирык ивнин ԓюур ынӄэн ытԓьата	э м э ԓ к э _ ы т ԓ ы г ы н _ т ы н р а г т а т ы н _ ӈ э в ъ э н э _ р э ԓ ь у г н и н _ ӄ э г ԓ ы н а н г э т _ а г т ы г ъ э _ п ы к и р ы к _ и в н и н _ ԓ ю у р _ ы н ӄ э н _ ы т ԓ ь а т а _
ивнин мэӈӄо ԓьугьэн эккэтэ	и в н и н _ м э ӈ ӄ о _ ԓ ь у г ь э н _ э к к э т э _
ивнин наӄам ымыԓьо гыткаԓгыт нымкыӄин эвын аӄаятыӈ гымнин ытԓыгын кымъэ гэпириԓин ытԓьата ивнин эккэтэ ивнин	и в н и н _ н а ӄ а м _ ы м ы ԓ ь о _ г ы т к а ԓ г ы т _ н ы м к ы ӄ и н _ э в ы н _ а ӄ а я т ы ӈ _ г ы м н и н _ ы т ԓ ы г ы н _ к ы м ъ э _ г э п и р и ԓ и н _ ы т ԓ ь а т а _ и в н и н _ э к к э т э _ и в н и н _
эмимъэԓик тынъэԓык ӄырым ԓым ыяагты мыԓӄытык	э м и м ъ э ԓ и к _ т ы н ъ э ԓ ы к _ ӄ ы р ы м _ ԓ ы м _ ы я а г т ы _ м ы ԓ ӄ ы т ы к _
вэԓерым ытԓыгын тыԓьугъэн ӄонпыӈ	в э ԓ е р ы м _ ы т ԓ ы г ы н _ т ы ԓ ь у г ъ э н _ ӄ о н п ы ӈ _
игыр тыпаак ытръэч эвэнэԓьэты игыр трэвинрээркын игыр ӄонпыӈ	и г ы р _ т ы п а а к _ ы т р ъ э ч _ э в э н э ԓ ь э т ы _ и г ы р _ т р э в и н р э э р к ы н _ и г ы р _ ӄ о н п ы ӈ _
ыяагты риӈэк тыпаак с	ы я а г т ы _ р и ӈ э к _ т ы п а а к _ с _
амыным аны ныԓгэӈъоӄэн ымы ваԓы чаат	а м ы н ы м _ а н ы _ н ы ԓ г э ӈ ъ о ӄ э н _ ы м ы _ в а ԓ ы _ ч а а т _
кукэт пойгыт уйӈэ наӄам	к у к э т _ п о й г ы т _ у й ӈ э _ н а ӄ а м _
ӈэԓвыԓ нымкыӄин	ӈ э ԓ в ы ԓ _ н ы м к ы ӄ и н _
энмэн нанӄытэмтэӈ ганымытваԓен	э н м э н _ н а н ӄ ы т э м т э ӈ _ г а н ы м ы т в а ԓ е н _
ытръэч тэӈэмӈэԓвыԓекы уйӈэ	ы т р ъ э ч _ т э ӈ э м ӈ э ԓ в ы ԓ е к ы _ у й ӈ э _
аракыԓьэн ымы ԓыгэн	а р а к ы ԓ ь э н _ ы м ы _ ԓ ы г э н _
ӄун ӈэвъэн уйӈэ таӈамынан	ӄ у н _ ӈ э в ъ э н _ у й ӈ э _ т а ӈ а м ы н а н _
ганымытваԓен ӈэԓвыԓекы амыным	г а н ы м ы т в а ԓ е н _ ӈ э ԓ в ы ԓ е к ы _ а м ы н ы м _
аны ныԓгэӈъоӄэн ымы	а н ы _ н ы ԓ г э ӈ ъ о ӄ э н _ ы м ы _
ваԓы чаат кукэт	в а ԓ ы _ ч а а т _ к у к э т _
пойгыт уйӈэ наӄам ӈэԓвыԓ нымкыӄин	п о й г ы т _ у й ӈ э _ н а ӄ а м _ ӈ э ԓ в ы ԓ _ н ы м к ы ӄ и н _
энмэн нанӄытэмтэӈ ынӄэн	э н м э н _ н а н ӄ ы т э м т э ӈ _ ы н ӄ э н _
нынны ынин аны ныԓгэӄамэтваӄэн	н ы н н ы _ ы н и н _ а н ы _ н ы ԓ г э ӄ а м э т в а ӄ э н _
ыныкит гытъэвкы ӄоԓ	ы н ы к и т _ г ы т ъ э в к ы _ ӄ о ԓ _
итгъи вуԓӄытвик ӄаанматгъэ ԓыгэн	и т г ъ и _ в у ԓ ӄ ы т в и к _ ӄ а а н м а т г ъ э _ ԓ ы г э н _
кытгынтыпэрэта рыннин ӄораӈы наӄам	к ы т г ы н т ы п э р э т а _ р ы н н и н _ ӄ о р а ӈ ы _ н а ӄ а м _
аны ныԓгининъыӄин нанӄытэмтэӈ чама	а н ы _ н ы ԓ г и н и н ъ ы ӄ и н _ н а н ӄ ы т э м т э ӈ _ ч а м а _
ныԓгэнымԓыӄэн ынӄэн ынкы	н ы ԓ г э н ы м ԓ ы ӄ э н _ ы н ӄ э н _ ы н к ы _
кытгынтыпэрэнэн ӄораӈы ынӄо риԓгыпэтэ	к ы т г ы н т ы п э р э н э н _ ӄ о р а ӈ ы _ ы н ӄ о _ р и ԓ г ы п э т э _
рыннин ынраӄ эрынвэ рыннинэт гыткат ԓыгэн мыԓенинэт гыткат мынга ынӄо тэтивэԓе инэвэнӈэтгъи	р ы н н и н _ ы н р а ӄ _ э р ы н в э _ р ы н н и н э т _ г ы т к а т _ ԓ ы г э н _ м ы ԓ е н и н э т _ г ы т к а т _ м ы н г а _ ы н ӄ о _ т э т и в э ԓ е _ и н э в э н ӈ э т г ъ и _
ынӄо ӄорэн нанӄын тэйкынин	ы н ӄ о _ ӄ о р э н _ н а н ӄ ы н _ т э й к ы н и н _
ынкъам мэмԓытыёнэн ынӄо рыратыквыткынык рытриԓнин ынӈин нувиӄин нанӄытэмтэӈ	ынкъам _ м э м ԓ ы т ы ё н э н _ ы н ӄ о _ р ы р а т ы к в ы т к ы н ы к _ р ы т р и ԓ н и н _ ы н ӈ и н _ н у в и ӄ и н _ н а н ӄ ы т э м т э ӈ _
ӄорананӄыткынык вычгывыквыткынык таӈымыԓьэты ыпаннэн аймак	ӄ о р а н а н ӄ ы т к ы н ы к _ в ы ч г ы в ы к в ы т к ы н ы к _ т а ӈ ы м ы ԓ ь э т ы _ ы п а н н э н _ а й м а к _
ынӄо гатарыгъёԓгынԓен нанӄыванвыԓӄыԓ гэтэйкыԓин	ы н ӄ о _ г а т а р ы г ъ ё ԓ г ы н ԓ е н _ н а н ӄ ы в а н в ы ԓ ӄ ы ԓ _ г э т э й к ы ԓ и н _
амыным ӄамэтваӈӈогъэ	а м ы н ы м _ ӄ а м э т в а ӈ ӈ о г ъ э _
апаӄатԓыткогъэ аны гаӄамэтваԓен таӈымыԓьэты	а п а ӄ а т ԓ ы т к о г ъ э _ а н ы _ г а ӄ а м э т в а ԓ е н _ т а ӈ ы м ы ԓ ь э т ы _
кунин ӄаанмэ	к у н и н _ ӄ а а н м э _
ынӄо ӄутгъи	ы н ӄ о _ ӄ у т г ъ и _
нанӄыйӈын гэԓгимэйӈэтԓин гагэнрычгатԓен ынӄо ӈиԓгэ тимтигнин нанӄын	н а н ӄ ы й ӈ ы н _ г э ԓ г и м э й ӈ э т ԓ и н _ г а г э н р ы ч г а т ԓ е н _ ы н ӄ о _ ӈ и ԓ г э _ т и м т и г н и н _ н а н ӄ ы н _
ӈэԓвыԓ вэгтиԓгъи наӄам ыныкит ныгытъэвӄин	ӈ э ԓ в ы ԓ _ в э г т и ԓ г ъ и _ н а ӄ а м _ ы н ы к и т _ н ы г ы т ъ э в ӄ и н _
ныԓгимӄытвиӄин нанӄын наӄам ыныкит ныпԓыӄамэтваӄэн	н ы ԓ г и м ӄ ы т в и ӄ и н _ н а н ӄ ы н _ н а ӄ а м _ ы н ы к и т _ н ы п ԓ ы ӄ а м э т в а ӄ э н _
ныԓгэгэнрычгатӄэн нанӄын рыпэт	н ы ԓ г э г э н р ы ч г а т ӄ э н _ н а н ӄ ы н _ р ы п э т _
ӄун кыԓтэ	ӄ у н _ к ы ԓ т э _
нинэтчыӄин нанӄын ынӄэн	н и н э т ч ы ӄ и н _ н а н ӄ ы н _ ы н ӄ э н _
тэӈэмынӈин ганымытваԓен тумгэӄэй нанӄытэмтэӈ амын ӄоԓ итгъи вуԓӄытвик нэмэ ӄаанматгъэ ынраӄ нымэчыӄэргыԓьатӄэн	т э ӈ э м ы н ӈ и н _ г а н ы м ы т в а ԓ е н _ т у м г э ӄ э й _ н а н ӄ ы т э м т э ӈ _ а м ы н _ ӄ о ԓ _ и т г ъ и _ в у ԓ ӄ ы т в и к _ н э м э _ ӄ а а н м а т г ъ э _ ы н р а ӄ _ н ы м э ч ы ӄ э р г ы ԓ ь а т ӄ э н _
увэма ӈэԓвыԓым нытԓытваӄэн ԓюур вай рымъэйӈэткун авач авач ԓыгэн эвыр	у в э м а _ ӈ э ԓ в ы ԓ ы м _ н ы т ԓ ы т в а ӄ э н _ ԓ ю у р _ в а й _ р ы м ъ э й ӈ э т к у н _ а в а ч _ а в а ч _ ԓ ы г э н _ э в ы р _
гагчыръогъэ нанӄытэмтэӈ эӄыԓпэ эръыкыргыт ӈирэӄ энатыёйвынэнат уунъыкэнъутэ ынкъам рытрэтэ	г а г ч ы р ъ о г ъ э _ н а н ӄ ы т э м т э ӈ _ э ӄ ы ԓ п э _ э р ъ ы к ы р г ы т _ ӈ и р э ӄ _ э н а т ы ё й в ы н э н а т _ у у н ъ ы к э н ъ у т э _ ы н к ъ а м _ р ы т р э т э _
ԓьуԓӄыԓеннинэт ынӄоым мачыяа рывакъовнэнат ӈирэк рытрэԓьуԓӄытԓьэт	ԓ ь у ԓ ӄ ы ԓ е н н и н э т _ ы н ӄ о ы м _ м а ч ы я а _ р ы в а к ъ о в н э н а т _ ӈ и р э к _ р ы т р э ԓ ь у ԓ ӄ ы т ԓ ь э т _
эръыкыргыт аны ӈоты	э р ъ ы к ы р г ы т _ а н ы _ ӈ о т ы _
энмэч гапкэрыӈӈоԓен ӄытԓыги эӄэԓьымкын ӈэԓвыԓым ынкы	э н м э ч _ г а п к э р ы ӈ ӈ о ԓ е н _ ӄ ы т ԓ ы г и _ э ӄ э ԓ ь ы м к ы н _ ӈ э ԓ в ы ԓ ы м _ ы н к ы _
нытԓытваӄэн панэна ынӄо атчысӄэквъэ нанӄытэмтэӈ	н ы т ԓ ы т в а ӄ э н _ п а н э н а _ ы н ӄ о _ а т ч ы с ӄ э к в ъ э _ н а н ӄ ы т э м т э ӈ _
омкычыкогты аны вай ныԓӄэгнэвъюуӄинэт	о м к ы ч ы к о г т ы _ а н ы _ вай _ н ы ԓ ӄ э г н э в ъ ю у ӄ и н э т _
мачыяа вакъотваԓьыт	м а ч ы я а _ в а к ъ о т в а ԓ ь ы т _
эръыкыргыт тиӈурэ нынпыткэвъюуӄинэт	э р ъ ы к ы р г ы т _ т и ӈ у р э _ н ы н п ы т к э в ъ ю у ӄ и н э т _
тиӈурмъэмитэ вачаӄ	т и ӈ у р м ъ э м и т э _ в а ч а ӄ _
ванэван ынынпэӄэттавынат эръыкыргыт	в а н э в а н _ ы н ы н п э ӄ э т т а в ы н а т _ э р ъ ы к ы р г ы т _
миӈкыри ӄун нивӄинэт ытри энмэн ынӄэнат	м и ӈ к ы р и _ ӄ у н _ н и в ӄ и н э т _ ы т р и _ э н м э н _ ы н ӄ э н а т _
ӈирэӄ оравэтԓьат натаӈыԓвавынат тымык	ӈ и р э ӄ _ о р а в э т ԓ ь а т _ н а т а ӈ ы ԓ в а в ы н а т _ т ы м ы к _
ӄынвэр найъонат ӈирэӄ эръыкыргыт ӄытԓыги ынӄэнат эръыкыргыт ытръэч уунъыкэнъутэ гэнатыёԓенат выԓ нымкыӄин наӄам уйӈэ этынвыка	ӄ ы н в э р _ н а й ъ о н а т _ ӈ и р э ӄ _ э р ъ ы к ы р г ы т _ ӄ ы т ԓ ы г и _ ы н ӄ э н а т _ э р ъ ы к ы р г ы т _ ы т р ъ э ч _ у у н ъ ы к э н ъ у т э _ г э н а т ы ё ԓ е н а т _ в ы ԓ _ н ы м к ы ӄ и н _ н а ӄ а м _ у й ӈ э _ э т ы н в ы к а _
опопы моргынан	о п о п ы _ м о р г ы н а н _
ӈэԓвыԓ мыныԓгын миӈкыри ӄун эми авынраԓьыт энмэч эргатык	ӈ э ԓ в ы ԓ _ м ы н ы ԓ г ы н _ м и ӈ к ы р и _ ӄ у н _ э м и _ а в ы н р а ԓ ь ы т _ э н м э ч _ э р г а т ы к _
мынагтатын ӈэԓвыԓ тумгытым ночыткоӄэнат	м ы н а г т а т ы н _ ӈ э ԓ в ы ԓ _ т у м г ы т ы м _ н о ч ы т к о ӄ э н а т _
нанвэтгавын ӈэԓвыԓ эргатык агтатынвы амыным энмэч тэӈунтымэквъэт ынкы ӄамэтваԓьатгъат ынкы эчги ӄэмипԓыткугъэт ынкы	н а н в э т г а в ы н _ ӈ э ԓ в ы ԓ _ э р г а т ы к _ а г т а т ы н в ы _ а м ы н ы м _ э н м э ч _ т э ӈ у н т ы м э к в ъ э т _ ы н к ы _ ӄ а м э т в а ԓ ь а т г ъ а т _ ы н к ы _ э ч г и _ ӄ э м и п ԓ ы т к у г ъ э т _ ы н к ы _
ԓыгэн йыԓӄатчагъат наӄам таӈымыԓьо ирвыгинив ыннэнԓеӈкы натанмайӈэвынат ынӄоым йыԓӄатчагъат амыным нанӄытэмтэӈына чамэттанэнат	ԓ ы г э н _ й ы ԓ ӄ а т ч а г ъ а т _ н а ӄ а м _ т а ӈ ы м ы ԓ ь о _ и р в ы г и н и в _ ы н н э н ԓ е ӈ к ы _ н а т а н м а й ӈ э в ы н а т _ ы н ӄ о ы м _ й ы ԓ ӄ а т ч а г ъ а т _ а м ы н ы м _ н а н ӄ ы т э м т э ӈ ы н а _ ч а м э т т а н э н а т _
йыԓӄыԓьыт йъонэнат эвын	й ы ԓ ӄ ы ԓ ь ы т _ й ъ о н э н а т _ э в ы н _
таӈвытрыӈ ныйыԓӄатчаӄэнат аӄаԓымкиӈыт ынӄо танмайӈытваԓьыт ирвыгинив майынԓяйвынэнат нотагты омкычыкогты ынӄо йъонэнат	т а ӈ в ы т р ы ӈ _ н ы й ы ԓ ӄ а т ч а ӄ э н а т _ а ӄ а ԓ ы м к и ӈ ы т _ ы н ӄ о _ т а н м а й ӈ ы т в а ԓ ь ы т _ и р в ы г и н и в _ м а й ы н ԓ я й в ы н э н а т _ н о т а г т ы _ о м к ы ч ы к о г т ы _ ы н ӄ о _ й ъ о н э н а т _
йыԓӄыԓьыт ытръэч ыннэн пойгын рынрынин	й ы ԓ ӄ ы ԓ ь ы т _ ы т р ъ э ч _ ы н н э н _ п о й г ы н _ р ы н р ы н и н _
эвын ныӄынӈырвэԓыръоӄэнат эӄэԓьыгинив	э в ы н _ н ы ӄ ы н ӈ ы р в э ԓ ы р ъ о ӄ э н а т _ э ӄ э ԓ ь ы г и н и в _
аны рымъэйӈэнинэт эӄэԓьыгинив	а н ы _ р ы м ъ э й ӈ э н и н э т _ э ӄ э ԓ ь ы г и н и в _
ынӄо йъонэнат йыԓӄыԓьыт ытръэч ыннэн пойгын	ы н ӄ о _ й ъ о н э н а т _ й ы ԓ ӄ ы ԓ ь ы т _ ы т р ъ э ч _ ы н н э н _ п о й г ы н _
рынрынин эвын ныӄынӈырвэԓыръоӄэнат эӄэԓьыгинив аны рымъэйӈэнинэт эӄэԓьыгинив аны гараԓеԓӄотчаԓенат	р ы н р ы н и н _ э в ы н _ н ы ӄ ы н ӈ ы р в э ԓ ы р ъ о ӄ э н а т _ э ӄ э ԓ ь ы г и н и в _ а н ы _ р ы м ъ э й ӈ э н и н э т _ э ӄ э ԓ ь ы г и н и в _ а н ы _ г а р а ԓ е ԓ ӄ о т ч а ԓ е н а т _
аӄаԓьымкычгын ԓыгэн ԓыԓенвэнтинэӈу ныпойгырэтръоӄэнат уйӈэ	а ӄ а ԓ ь ы м к ы ч г ы н _ ԓ ы г э н _ ԓ ы ԓ е н в э н т и н э ӈ у _ н ы п о й г ы р э т р ъ о ӄ э н а т _ у й ӈ э _
ԓьук ныԓвавӄэнат аны ынкы кэмчичевръуԓьыт	ԓ ь у к _ н ы ԓ в а в ӄ э н а т _ а н ы _ ынкы _ к э м ч и ч е в р ъ у ԓ ь ы т _
ԓыгэн нэнанмыткойвыӄэнат пойга нанӄытэмтэӈына	ԓ ы г э н _ н э н а н м ы т к о й в ы ӄ э н а т _ п о й г а _ н а н ӄ ы т э м т э ӈ ы н а _
ынкы тымыткойвынэнат таӈымыԓьо	ы н к ы _ т ы м ы т к о й в ы н э н а т _ т а ӈ ы м ы ԓ ь о _
ынӄо	ы н ӄ о _
тумгэӄэй нанӄытэмтэӈ ирвынӈэгъи игырым эӄэԓьэ нарынноркын	т у м г э ӄ э й _ н а н ӄ ы т э м т э ӈ _ и р в ы н ӈ э г ъ и _ и г ы р ы м _ э ӄ э ԓ ь э _ н а р ы н н о р к ы н _
вуԓӄытвигъи	в у ԓ ӄ ы т в и г ъ и _
ԓюур ӈайъэннысӄэпы ининигъи	ԓ ю у р _ ӈ а й ъ э н н ы с ӄ э п ы _ и н и н и г ъ и _
этратчыӈын эвын гаӄоԓема ныԓгирымъэйӈэткуӄинэт	э т р а т ч ы ӈ ы н _ э в ы н _ г а ӄ о ԓ е м а _ н ы ԓ г и р ы м ъ э й ӈ э т к у ӄ и н э т _
нанӄытэмтэӈ нанӄытэмтэӈым нытаӈонтымытваӄэн таӈванэван найыԓгавын энмэч нытэнмавыткоӄэн ԓюур	н а н ӄ ы т э м т э ӈ _ н а н ӄ ы т э м т э ӈ ы м _ н ы т а ӈ о н т ы м ы т в а ӄ э н _ т а ӈ в а н э в а н _ н а й ы ԓ г а в ы н _ э н м э ч _ н ы т э н м а в ы т к о ӄ э н _ ԓ ю у р _
пыкэтчагъат аӄаԓымкиӈын накамԓеԓтагъан нанӄытэмтэӈ аны	п ы к э т ч а г ъ а т _ а ӄ а ԓ ы м к и ӈ ы н _ н а к а м ԓ е ԓ т а г ъ а н _ н а н ӄ ы т э м т э ӈ _ а н ы _
нанӄытэмтэӈына пойгычгын гэниԓюԓин	н а н ӄ ы т э м т э ӈ ы н а _ п о й г ы ч г ы н _ г э н и ԓ ю ԓ и н _
ԓюур гыргоԓятгъэ таӈампойгыԓьата	ԓ ю у р _ г ы р г о ԓ я т г ъ э _ т а ӈ а м п о й г ы ԓ ь а т а _
нанӄытэмтэӈ ооԓёкоԓё аны ныԓгинымкыӄин аӄаԓьэтратчыӈын ԓюур выентэтгъи	н а н ӄ ы т э м т э ӈ _ о о ԓ ё к о ԓ ё _ а н ы _ н ы ԓ г и н ы м к ы ӄ и н _ а ӄ а ԓ ь э т р а т ч ы ӈ ы н _ ԓ ю у р _ в ы е н т э т г ъ и _
камԓеԓтаё нанӄытэмтэӈ аны ынкы	к а м ԓ е ԓ т а ё _ н а н ӄ ы т э м т э ӈ _ а н ы _ ы н к ы _
моогъат маравкы наӄам пойгыԓьата мараквъат амыным нэмэ	м о о г ъ а т _ м а р а в к ы _ н а ӄ а м _ п о й г ы ԓ ь а т а _ м а р а к в ъ а т _ а м ы н ы м _ н э м э _
нанӄытэмтэӈына тэӈыткунин	н а н ӄ ы т э м т э ӈ ы н а _ т э ӈ ы т к у н и н _
эӄэԓьырэт этки гэрмэвԓин нанӄытэмтэӈ чама	э ӄ э ԓ ь ы р э т _ э т к и _ г э р м э в ԓ и н _ н а н ӄ ы т э м т э ӈ _ ч а м а _
гамчытвэԓен нэмэ рымагтэты нымытваӈӈогъэ	г а м ч ы т в э ԓ е н _ н э м э _ р ы м а г т э т ы _ н ы м ы т в а ӈ ӈ о г ъ э _
итыкым ныйъойвыӄэн эӄэԓьэ вачаӄым тымык натаӈыԓвавын ӄоԓ	и т ы к ы м _ н ы й ъ о й в ы ӄ э н _ э ӄ э ԓ ь э _ в а ч а ӄ ы м _ т ы м ы к _ н а т а ӈ ы ԓ в а в ы н _ ӄ о ԓ _
итгъи ӈайыткынэты ёпыԓӄэквъэ нанӄытэмтэӈ	и т г ъ и _ ӈ а й ы т к ы н э т ы _ ё п ы ԓ ӄ э к в ъ э _ н а н ӄ ы т э м т э ӈ _
ԓюур ԓьунин ынкы	ԓ ю у р _ ԓ ь у н и н _ ы н к ы _
ӈэвысӄэт ӈэйык ивтыԓ нэнамӈыԓёӄэн нанӄытэмтэӈына ӈэвысӄэт эмъим	ӈ э в ы с ӄ э т _ ӈ э й ы к _ и в т ы ԓ _ н э н а м ӈ ы ԓ ё ӄ э н _ н а н ӄ ы т э м т э ӈ ы н а _ ӈ э в ы с ӄ э т _ э м ъ и м _
гынин ытԓьатэвытԓымым йичьэмиттумгыт кытвыԓӄуным рэӄэ нытэйӈэтигыт ынкъам ынӈин нытэйӈэтигым ынӄо	г ы н и н _ ы т ԓ ь а т э в ы т ԓ ы м ы м _ й и ч ь э м и т т у м г ы т _ к ы т в ы ԓ ӄ у н ы м _ р э ӄ э _ н ы т э й ӈ э т и г ы т _ ы н к ъ а м _ ы н ӈ и н _ н ы т э й ӈ э т и г ы м _ ы н ӄ о _
ԓыгиейвэчеквъи нанӄытэмтэӈ ивнин эвыр гынин нэмыӄэй уйӈэ	ԓ ы г и е й в э ч е к в ъ и _ н а н ӄ ы т э м т э ӈ _ и в н и н _ э в ы р _ г ы н и н _ н э м ы ӄ э й _ у й ӈ э _
опопы кынмаԓ мыннымытва	о п о п ы _ к ы н м а ԓ _ м ы н н ы м ы т в а _
ԓыгэным ӈэвысӄэт ԓыгэкоргаквъэ	ԓ ы г э н ы м _ ӈ э в ы с ӄ э т _ ԓ ы г э к о р г а к в ъ э _
ынӄо эквэтгъэт ӈаԓвыԓьэты	ы н ӄ о _ э к в э т г ъ э т _ ӈ а ԓ в ы ԓ ь э т ы _
аны ганымытваԓенат ынкы	а н ы _ г а н ы м ы т в а ԓ е н а т _ ы н к ы _
энмэчым гаранӈаԓенат ытри энмэчым	э н м э ч ы м _ г а р а н ӈ а ԓ е н а т _ ы т р и _ э н м э ч ы м _
аккантогъэ ӈэвъэн йытонэн ӈинӄэй	а к к а н т о г ъ э _ ӈ э в ъ э н _ й ы т о н э н _ ӈ и н ӄ э й _
умиԓгуну нынны гитԓин ынӄо эчги	у м и ԓ г у н у _ н ы н н ы _ г и т ԓ и н _ ы н ӄ о _ э ч г и _
ӈэръамытԓыӈгэвэԓьо нъэԓгъи умиԓгу нэмэ ӄоԓ ӈинӄэй урэтгъи	ӈ э р ъ а м ы т ԓ ы ӈ г э в э ԓ ь о _ н ъ э ԓ г ъ и _ у м и ԓ г у _ н э м э _ ӄ о ԓ _ ӈ и н ӄ э й _ у р э т г ъ и _
ынӄэнат ӈинӄэгти мэйӈэтгъэт энмэч	ы н ӄ э н а т _ ӈ и н ӄ э г т и _ м э й ӈ э т г ъ э т _ э н м э ч _
мачамнотайпы ныԓейвыӄинэт гэтԓенъютэ ԓыгэным	м а ч а м н о т а й п ы _ н ы ԓ е й в ы ӄ и н э т _ г э т ԓ е н ъ ю т э _ ԓ ы г э н ы м _
ԓыгэыяагты ныԓӄытыԓьэтӄинэт нанӄытэмтэӈын эккэт	ԓ ы г э ы я а г т ы _ н ы ԓ ӄ ы т ы ԓ ь э т ӄ и н э т _ н а н ӄ ы т э м т э ӈ ы н _ э к к э т _
наӄам ытԓыгын пэнин ӄораӄ	н а ӄ а м _ ы т ԓ ы г ы н _ п э н и н _ ӄ о р а ӄ _
ваԓьын нмэч умиԓгу мачьаачеко гэнъэтԓин ытԓеӈиым энмэч майӈыӈэнӄагчыӈын умиԓгун ытԓенъюн нынны	в а ԓ ь ы н _ н м э ч _ у м и ԓ г у _ м а ч ь а а ч е к о _ г э н ъ э т ԓ и н _ ы т ԓ е ӈ и ы м _ э н м э ч _ м а й ӈ ы ӈ э н ӄ а г ч ы ӈ ы н _ у м и ԓ г у н _ ы т ԓ е н ъ ю н _ н ы н н ы _
тутъыԓӄут аны ӄытԓыги	т у т ъ ы ԓ ӄ у т _ а н ы _ ӄ ы т ԓ ы г и _
ытри нырэрмэвӈыӄинэт ынӄо	ы т р и _ н ы р э р м э в ӈ ы ӄ и н э т _ ы н ӄ о _
эчги тутъыԓӄут мэйӈэтгъи аатчеко нъэԓгъи ивнин	э ч г и _ т у т ъ ы ԓ ӄ у т _ м э й ӈ э т г ъ и _ а а т ч е к о _ н ъ э ԓ г ъ и _ и в н и н _
умиԓгунэ	у м и ԓ г у н э _
ынӄо амъянра нъэԓгъэт аны котчой нутэк нытваӄэнат тэӈэмкытэ	ы н ӄ о _ а м ъ я н р а _ н ъ э ԓ г ъ э т _ а н ы _ к о т ч о й _ н у т э к _ н ы т в а ӄ э н а т _ т э ӈ э м к ы т э _
ярагты ныԓӄытӄинэт ԓюур ӄуԓиникэк тутъыԓӄутынэ ивнин ынээԓьын нутэк	я р а г т ы _ н ы ԓ ӄ ы т ӄ и н э т _ ԓ ю у р _ ӄ у ԓ и н и к э к _ т у т ъ ы ԓ ӄ у т ы н э _ и в н и н _ ы н э э ԓ ь ы н _ н у т э к _
миӈкыри ӄун умиԓгу вэнъым гаԓгэмчытвэԓен ынкъам умиԓгунэ нинивӄин	м и ӈ к ы р и _ ӄ у н _ у м и ԓ г у _ в э н ъ ы м _ г а ԓ г э м ч ы т в э ԓ е н _ ы н к ъ а м _ у м и ԓ г у н э _ н и н и в ӄ и н _
ытԓеӈи тутъыԓӄутынэ вэнԓыги нинивъюуӄин ынээԓьын	ы т ԓ е ӈ и _ т у т ъ ы ԓ ӄ у т ы н э _ в э н ԓ ы г и _ н и н и в ъ ю у ӄ и н _ ы н э э ԓ ь ы н _
еп ныппыԓюйгыт энмэч этъоонмыԓ эвыр мэчынкы	е п _ н ы п п ы ԓ ю й г ы т _ э н м э ч _ э т ъ о о н м ы ԓ _ э в ы р _ м э ч ы н к ы _
рэнъэԓгъэ мачынан ынӈин ӄытваркын	р э н ъ э ԓ г ъ э _ м а ч ы н а н _ ы н ӈ и н _ ӄ ы т в а р к ы н _
ынӈэ акаԓырока энмэч рымагтэты атав мынԓеркын ынӄо эквэтгъэт	ы н ӈ э _ а к а ԓ ы р о к а _ э н м э ч _ р ы м а г т э т ы _ а т а в _ м ы н ԓ е р к ы н _ ы н ӄ о _ э к в э т г ъ э т _
амъянра нэмэ ӄуԓиникэк ԓьувыԓгык ивнин ытԓенъютэ	а м ъ я н р а _ н э м э _ ӄ у ԓ и н и к э к _ ԓ ь у в ы ԓ г ы к _ и в н и н _ ы т ԓ е н ъ ю т э _
ынээԓьэ ивнин гытым эквэтгъэт нэмэ амъянра	ы н э э ԓ ь э _ ивнин _ г ы т ы м _ э к в э т г ъ э т _ н э м э _ а м ъ я н р а _
нотагты гаԓгоратваԓенат нэмэ эԓьувыԓгыкэ ӄуԓиникэк нэмэ	н о т а г т ы _ г а ԓ г о р а т в а ԓ е н а т _ н э м э _ э ԓ ь у в ы ԓ г ы к э _ ӄ у ԓ и н и к э к _ н э м э _
ԓьувыԓгыгъэт нэмэ йынатъёоӈӈонэн ытԓенъютэ умиԓгу нинивӄин ынӈатаԓым	ԓ ь у в ы ԓ г ы г ъ э т _ н э м э _ й ы н а т ъ ё о ӈ ӈ о н э н _ ы т ԓ е н ъ ю т э _ у м и ԓ г у _ н и н и в ӄ и н _ ы н ӈ а т а ԓ ы м _
эты игыр тыйъогыр умиԓгу нычимгъуӄин нивӄин нинивӄин	э т ы _ и г ы р _ т ы й ъ о г ы р _ у м и ԓ г у _ н ы ч и м г ъ у ӄ и н _ н и в ӄ и н _ н и н и в ӄ и н _
ытԓенъютэ умиԓгунэ ивнин вынэ эвыр опопы амыным моогъат	ы т ԓ е н ъ ю т э _ у м и ԓ г у н э _ и в н и н _ в ы н э _ э в ы р _ о п о п ы _ а м ы н ы м _ м о о г ъ а т _
тэйкэвкы иам нэнагнатъёоӄэн ынээԓьын тутъыԓӄутынэ миӈкыри ӄун	т э й к э в к ы _ и а м _ н э н а г н а т ъ ё о ӄ э н _ ы н э э ԓ ь ы н _ т у т ъ ы ԓ ӄ у т ы н э _ м и ӈ к ы р и _ ӄ у н _
ытԓён ёргэты ваԓьын чама	ы т ԓ ё н _ ё р г э т ы _ в а ԓ ь ы н _ ч а м а _
тотъэты ваԓьын ынкъам ынӄэната ынээԓьын нэнагнатӄэн	т о т ъ э т ы _ в а ԓ ь ы н _ ы н к ъ а м _ ы н ӄ э н а т а _ ы н э э ԓ ь ы н _ н э н а г н а т ӄ э н _
ԓыгэн ӄун ёргэты ваԓьын	ԓ ы г э н _ ӄ у н _ ё р г э т ы _ в а ԓ ь ы н _
аны нинэнтэйкэвэтӄин ынээԓьэ аны ӄэйвэ гэԓгэрмэвӄээтԓин тутъыԓӄутӄэй	а н ы _ н и н э н т э й к э в э т ӄ и н _ ы н э э ԓ ь э _ а н ы _ ӄ э й в э _ г э ԓ г э р м э в ӄ э э т ԓ и н _ т у т ъ ы ԓ ӄ у т ӄ э й _
рыпэт	р ы п э т _
ӄун нутэсӄын ӄынур ыԓьыԓ 	ӄ у н _ н у т э с ӄ ы н _ ӄ ы н у р _ ы ԓ ь ы ԓ _ _
гыткат ӈэнри нунрэпэтӄинэт миԓгунэ	г ы т к а т _ ӈ э н р и _ н у н р э п э т ӄ и н э т _ м и ԓ г у н э _
эннэпы эйминнин ынкъам нинэтиӈуткуӄин ыныкаӈӄачагты	э н н э п ы _ э й м и н н и н _ ынкъам _ н и н э т и ӈ у т к у ӄ и н _ ы н ы к а ӈ ӄ а ч а г т ы _
аны ныкытъыматыԓьатӄэн тутъыԓӄут 	а н ы _ н ы к ы т ъ ы м а т ы ԓ ь а т ӄ э н _ т у т ъ ы ԓ ӄ у т _ _
ытԓенъюӄэй ԓюур ръэнут пэгԓягъэ ԓыгэн	ы т ԓ е н ъ ю ӄ э й _ ԓ ю у р _ р ъ э н у т _ п э г ԓ я г ъ э _ ԓ ы г э н _
эвыр ынкэӄэй пэӄэттатгъэ ытԓеӈи ӄытԓыги ытԓенъюн	э в ы р _ ы н к э ӄ э й _ п э ӄ э т т а т г ъ э _ ы т ԓ е ӈ и _ ӄ ы т ԓ ы г и _ ы т ԓ е н ъ ю н _
гыткаԓгын рыйыԓгынтэннин аны гакапчачавԓен	г ы т к а ԓ г ы н _ р ы й ы ԓ г ы н т э н н и н _ а н ы _ г а к а п ч а ч а в ԓ е н _
умиԓгу чама гэейвэчетԓин тотъытԓянъёгты ынӄо рырагтаннэн нотайпы	у м и ԓ г у _ ч а м а _ г э е й в э ч е т ԓ и н _ т о т ъ ы т ԓ я н ъ ё г т ы _ ы н ӄ о _ р ы р а г т а н н э н _ н о т а й п ы _
имтитэ ытԓыгэ пынԓёнэн авъеткынка нытваӄэн умиԓгу ынӄо ытԓеӈи иквъи ынӄо	и м т и т э _ ы т ԓ ы г э _ п ы н ԓ ё н э н _ а в ъ е т к ы н к а _ н ы т в а ӄ э н _ у м и ԓ г у _ ы н ӄ о _ ы т ԓ е ӈ и _ и к в ъ и _ ы н ӄ о _
ытԓыгын иквъи ынӄо умиԓгу нэмэ эквэтгъи ытԓеӈиым ярак пэԓятгъэ ярак	ы т ԓ ы г ы н _ и к в ъ и _ ы н ӄ о _ у м и ԓ г у _ н э м э _ э к в э т г ъ и _ ы т ԓ е ӈ и ы м _ я р а к _ п э ԓ я т г ъ э _ я р а к _
гаԓгоратъыԓытваԓен тутъыԓӄут ынӄо мэԓеквъи тутъыԓӄут ԓыгэн эвыр	г а ԓ г о р а т ъ ы ԓ ы т в а ԓ е н _ т у т ъ ы ԓ ӄ у т _ ы н ӄ о _ м э ԓ е к в ъ и _ т у т ъ ы ԓ ӄ у т _ ԓ ы г э н _ э в ы р _
эквэтгъи нотагты тутъыԓӄут аны горатваԓен тутъыԓӄут рэрмэвӈык	э к в э т г ъ и _ н о т а г т ы _ т у т ъ ы ԓ ӄ у т _ а н ы _ г о р а т в а ԓ е н _ т у т ъ ы ԓ ӄ у т _ р э р м э в ӈ ы к _
ӄынвэр нэмэ ԓюур ԓьувыԓгыгъэт гэнээԓьэ ынкы	ӄ ы н в э р _ н э м э _ ԓ ю у р _ ԓ ь у в ы ԓ г ы г ъ э т _ г э н э э ԓ ь э _ ы н к ы _
ынээԓьын гаԓгэкоргавԓен ынӄо	ы н э э ԓ ь ы н _ г а ԓ г э к о р г а в ԓ е н _ ы н ӄ о _
ивнин умиԓгунэ ытԓеӈи ынӄэным	и в н и н _ у м и ԓ г у н э _ ы т ԓ е ӈ и _ ы н ӄ э н ы м _
виин раԓьонъёно	в и и н _ р а ԓ ь о н ъ ё н о _
мыныԓгын энмэч виин ёпынвыӈаеты	м ы н ы ԓ г ы н _ э н м э ч _ в и и н _ ё п ы н в ы ӈ а е т ы _
мынытԓепыткусӄивмык ёпынвыӈаеты эквэтгъэт	м ы н ы т ԓ е п ы т к у с ӄ и в м ы к _ ё п ы н в ы ӈ а е т ы _ э к в э т г ъ э т _
гэтԓенъютэ аны	г э т ԓ е н ъ ю т э _ а н ы _
ынкы гапэрӄытваԓенат ёпынвыӈайгэӈкы	ы н к ы _ г а п э р ӄ ы т в а ԓ е н а т _ ё п ы н в ы ӈ а й г э ӈ к ы _
ԓюур рай ӄоԓ	ԓ ю у р _ р а й _ ӄ о ԓ _
ёпыԓӄэвыԓьын ёпынвыӈаеты	ё п ы ԓ ӄ э в ы ԓ ь ы н _ ё п ы н в ы ӈ а е т ы _
аны ԓыгэн ӄынур йъаяӄ ныԓеӄин наӄам	а н ы _ ԓ ы г э н _ ӄ ы н у р _ й ъ а я ӄ _ н ы ԓ е ӄ и н _ н а ӄ а м _
иԓгиръыԓьын ынӄэн ёпыԓӄэвыԓьын	и ԓ г и р ъ ы ԓ ь ы н _ ы н ӄ э н _ ё п ы ԓ ӄ э в ы ԓ ь ы н _
торъаатчек туринъытвиԓьын ынӄо ынӄэн	т о р ъ а а т ч е к _ т у р и н ъ ы т в и ԓ ь ы н _ ы н ӄ о _ ы н ӄ э н _
оравэтԓьан кытэӄэй ынкы	о р а в э т ԓ ь а н _ к ы т э ӄ э й _ ы н к ы _
вагъэ ынӄо эквэтгъи ынӄо нэмэ	в а г ъ э _ ы н ӄ о _ э к в э т г ъ и _ ы н ӄ о _ н э м э _
ӄоԓ пыкиргъи ёпынвыӈаеты ынраӄ	ӄ о ԓ _ п ы к и р г ъ и _ ё п ы н в ы ӈ а е т ы _ ы н р а ӄ _
ытԓенъютэ нинивӄин ынээԓьын нинивӄин умиԓгунэ наӄам мэрынрэӄэй	ы т ԓ е н ъ ю т э _ н и н и в ӄ и н _ ы н э э ԓ ь ы н _ н и н и в ӄ и н _ у м и ԓ г у н э _ н а ӄ а м _ м э р ы н р э ӄ э й _
нывэтгавӄэнат ытри нинивӄин ытԓенъютэ ӄынвэр эквэтгъи	н ы в э т г а в ӄ э н а т _ ы т р и _ н и н и в ӄ и н _ ы т ԓ е н ъ ю т э _ ӄ ы н в э р _ э к в э т г ъ и _
ԓюур ӄуԓиникэк коԓё пыкитчыӄиквъи оравэтԓьан ӄынур кэйӈын аны	ԓ ю у р _ ӄ у ԓ и н и к э к _ к о ԓ ё _ п ы к и т ч ы ӄ и к в ъ и _ о р а в э т ԓ ь а н _ ӄ ы н у р _ к э й ӈ ы н _ а н ы _
ынӄэн ытԓенъюӄэй наӄамԓым ԓыгайыԓгавыԓьатыӈӈой ынӄо ытԓён нивӄин ынӄэн	ы н ӄ э н _ ы т ԓ е н ъ ю ӄ э й _ н а ӄ а м ԓ ы м _ ԓ ы г а й ы ԓ г а в ы ԓ ь а т ы ӈ ӈ о й _ ы н ӄ о _ ы т ԓ ё н _ н и в ӄ и н _ ы н ӄ э н _
умиԓгу аны ытԓеӈи найыԓгавӄэн ытԓенъютэ	у м и ԓ г у _ а н ы _ ы т ԓ е ӈ и _ н а й ы ԓ г а в ӄ э н _ ы т ԓ е н ъ ю т э _
нинивӄин ынӄо ивнин ытԓеӈи	н и н и в ӄ и н _ ы н ӄ о _ и в н и н _ ы т ԓ е ӈ и _
эвыр рэнанмыгъа гым ынӈэ гыт вэты ӄун урэвкэ ԓыгэн ӄонпы ынкы	э в ы р _ р э н а н м ы г ъ а _ г ы м _ ы н ӈ э _ г ы т _ в э т ы _ ӄ у н _ у р э в к э _ ԓ ы г э н _ ӄ о н п ы _ ы н к ы _
ӄатчытваркын вытку рэквэтгъэ ытԓён ынкы	ӄ а т ч ы т в а р к ы н _ в ы т к у _ р э к в э т г ъ э _ ы т ԓ ё н _ ы н к ы _
вытку ӄэквэтги	в ы т к у _ ӄ э к в э т г и _
ярагты ынкъам ытԓыгын ӄынымӈыԓяквын аны ӈан эчги ёпынвыӈайык	я р а г т ы _ ынкъам _ ы т ԓ ы г ы н _ ӄ ы н ы м ӈ ы ԓ я к в ы н _ а н ы _ ӈ а н _ э ч г и _ ё п ы н в ы ӈ а й ы к _
тыттэтгъи танӈармайӈын аны гапэнрыԓен умиԓгунэ ынӄо ԓыгэн	т ы т т э т г ъ и _ т а н ӈ а р м а й ӈ ы н _ а н ы _ г а п э н р ы ԓ е н _ у м и ԓ г у н э _ ы н ӄ о _ ԓ ы г э н _
эвыр ивнин танӈармайӈа умиԓгу аны гапэнрыԓен умиԓгунэ	э в ы р _ и в н и н _ т а н ӈ а р м а й ӈ а _ у м и ԓ г у _ а н ы _ г а п э н р ы ԓ е н _ у м и ԓ г у н э _
ынӄо ԓыгэн эвыр ивнин танӈармайӈа умиԓгу аны ынраӄ моонэн пынԓёк танӈармайӈа ынӄо ивнин	ы н ӄ о _ ԓ ы г э н _ э в ы р _ и в н и н _ т а н ӈ а р м а й ӈ а _ у м и ԓ г у _ а н ы _ ы н р а ӄ _ м о о н э н _ п ы н ԓ ё к _ т а н ӈ а р м а й ӈ а _ ы н ӄ о _ и в н и н _
умиԓгунэ танӈармайӈын чеӈэрым мытԓьувыԓгымык аны гамгоԓенат пойгыԓьатык таӈымъыԓёӈэт	у м и ԓ г у н э _ т а н ӈ а р м а й ӈ ы н _ ч е ӈ э р ы м _ м ы т ԓ ь у в ы ԓ г ы м ы к _ а н ы _ г а м г о ԓ е н а т _ п о й г ы ԓ ь а т ы к _ т а ӈ ы м ъ ы ԓ ё ӈ э т _
гамаравԓенат инъэ моогъат маравкы	г а м а р а в ԓ е н а т _ и н ъ э _ м о о г ъ а т _ м а р а в к ы _
наӄам ёпынвыӈайкэн ԓявтыткын ныԓгинычьувӄин эрвъэӈэты ваԓьын таӈымъыԓёӈэт	н а ӄ а м _ ё п ы н в ы ӈ а й к э н _ ԓ я в т ы т к ы н _ н ы ԓ г и н ы ч ь у в ӄ и н _ э р в ъ э ӈ э т ы _ в а ԓ ь ы н _ т а ӈ ы м ъ ы ԓ ё ӈ э т _
гапойгыԓьатԓенат умиԓгу ытри танӈармачьиӈын ԓюур воԓӄытвэма тэкэм	г а п о й г ы ԓ ь а т ԓ е н а т _ у м и ԓ г у _ ы т р и _ т а н ӈ а р м а ч ь и ӈ ы н _ ԓ ю у р _ в о ԓ ӄ ы т в э м а _ т э к э м _
тиркытир нивтытвиӄин ынкы ԓюур почьакагыргык выквагъэ пойгырынрыянвыкэн поӄыткын	т и р к ы т и р _ н и в т ы т в и ӄ и н _ ы н к ы _ ԓ ю у р _ п о ч ь а к а г ы р г ы к _ в ы к в а г ъ э _ п о й г ы р ы н р ы я н в ы к э н _ п о ӄ ы т к ы н _
танӈармачьиӈэн ынӄо ԓыгэн	т а н ӈ а р м а ч ь и ӈ э н _ ы н ӄ о _ ԓ ы г э н _
эвыр пэӄэттатгъэ ынӄо иквъи энантэнмаквъэ энанмыгъэ энмэч	э в ы р _ п э ӄ э т т а т г ъ э _ ы н ӄ о _ и к в ъ и _ э н а н т э н м а к в ъ э _ э н а н м ы г ъ э _ э н м э ч _
ӄэнатаӈынмыгэ этки танӈыӈавыйӈа гагтойгым	ӄ э н а т а ӈ ы н м ы г э _ э т к и _ т а н ӈ ы ӈ а в ы й ӈ а _ г а г т о й г ы м _
майӈыпочьакагыргыԓьо ынӄо тымнэн умиԓгынэ танӈармайӈын ынӄэнына	м а й ӈ ы п о ч ь а к а г ы р г ы ԓ ь о _ ы н ӄ о _ т ы м н э н _ у м и ԓ г ы н э _ т а н ӈ а р м а й ӈ ы н _ ы н ӄ э н ы н а _
танӈармайӈа танԓымынӄо ниниткэйвыӄинэт ӈэԓвыԓьыт	т а н ӈ а р м а й ӈ а _ т а н ԓ ы м ы н ӄ о _ н и н и т к э й в ы ӄ и н э т _ ӈ э ԓ в ы ԓ ь ы т _
ынкъам ынанармачьо	ынкъам _ ы н а н а р м а ч ь о _
нитӄин ынӄэнайӈын наӄам ынин маравратчыӈын ныԓгинымкыӄин коԓё ԓыгэгаймычьыԓьыйӈо гатваԓен ынӄэнайӈын миӈкыри ӄун танԓымынӄо гаӄороткоԓьатԓен чама маравтомга нинэпириԓьэтӄинэт ӈочьыткойпы	н и т ӄ и н _ ы н ӄ э н а й ӈ ы н _ н а ӄ а м _ ы н и н _ м а р а в р а т ч ы ӈ ы н _ н ы ԓ г и н ы м к ы ӄ и н _ к о ԓ ё _ ԓ ы г э г а й м ы ч ь ы ԓ ь ы й ӈ о _ г а т в а ԓ е н _ ы н ӄ э н а й ӈ ы н _ м и ӈ к ы р и _ ӄ у н _ т а н ԓ ы м ы н ӄ о _ г а ӄ о р о т к о ԓ ь а т ԓ е н _ ч а м а _ м а р а в т о м г а _ н и н э п и р и ԓ ь э т ӄ и н э т _ ӈ о ч ь ы т к о й п ы _
ачак ынӄэнына ганмыԓен умиԓгуӄэйынэ аны ынӄэн ынкы пойгыԓьанма	а ч а к _ ы н ӄ э н ы н а _ г а н м ы ԓ е н _ у м и ԓ г у ӄ э й ы н э _ а н ы _ ы н ӄ э н _ ы н к ы _ п о й г ы ԓ ь а н м а _
ымъыԓёӈэт гапаӈъэватычгатԓен	ы м ъ ы ԓ ё ӈ э т _ г а п а ӈ ъ э в а т ы ч г а т ԓ е н _
танӈармачьын энмэч еԓычгын ганточгатԓен ныкэнчиӄыткуӄин	т а н ӈ а р м а ч ь ы н _ э н м э ч _ е ԓ ы ч г ы н _ г а н т о ч г а т ԓ е н _ н ы к э н ч и ӄ ы т к у ӄ и н _
ынӄо йъонэн ивтыԓ	ы н ӄ о _ й ъ о н э н _ и в т ы ԓ _
ваԓьын ытԓеӈи ынӄо ивнин ынинэԓьэ	в а ԓ ь ы н _ ы т ԓ е ӈ и _ ы н ӄ о _ и в н и н _ ы н и н э ԓ ь э _
ынӄо	ы н ӄ о _
рагтыгъат гэнээԓьэ	р а г т ы г ъ а т _ г э н э э ԓ ь э _
ынкы ӄэйыӄын паӈъэвӈытотвагъат гэтԓенъютэ ынӄо	ы н к ы _ ӄ э й ы ӄ ы н _ п а ӈ ъ э в ӈ ы т о т в а г ъ а т _ г э т ԓ е н ъ ю т э _ ы н ӄ о _
эквэтгъэт	э к в э т г ъ э т _
ны ынраӄ ынкы ныԓӄырирӄинэт ыргинэт	н ы _ ы н р а ӄ _ ы н к ы _ н ы ԓ ӄ ы р и р ӄ и н э т _ ы р г и н э т _
йъэԓгытомгыт ынкъам	й ъ э ԓ г ы т о м г ы т _ ы н к ъ а м _
ӄынвэр нэԓьунэт	ӄ ы н в э р _ н э ԓ ь у н э т _
ыннэн йъэԓгытомгын ныԓгэнымԓыӄэн	ы н н э н _ й ъ э ԓ г ы т о м г ы н _ н ы ԓ г э н ы м ԓ ы ӄ э н _
ыниным нынны пэрӄыё ыргиным гыттэпычьын	ы н и н ы м _ н ы н н ы _ п э р ӄ ы ё _ ы р г и н ы м _ г ы т т э п ы ч ь ы н _
нытваӄэн ымы	н ы т в а ӄ э н _ ы м ы _
ӄытԓыги энмэч ынин нынны вэтгавчьомыԓьо ытри	ӄ ы т ԓ ы г и _ э н м э ч _ ы н и н _ н ы н н ы _ в э т г а в ч ь о м ы ԓ ь о _ ы т р и _
нытваӄэнат эннысӄыткынык пыкиргъэт ынкы ԓыгэн эвыр эԓкыԓнинэт вэтгавчьомыԓьона ытԓывъёт	н ы т в а ӄ э н а т _ э н н ы с ӄ ы т к ы н ы к _ п ы к и р г ъ э т _ ы н к ы _ ԓ ы г э н _ э в ы р _ э ԓ к ы ԓ н и н э т _ в э т г а в ч ь о м ы ԓ ь о н а _ ы т ԓ ы в ъ ё т _
ивнинэт ынӄо ивнинэт вэтгавчьомыԓьона	и в н и н э т _ ы н ӄ о _ и в н и н э т _ в э т г а в ч ь о м ы ԓ ь о н а _
энмэч пэтԓе рэпкирӈыт	э н м э ч _ п э т ԓ е _ р э п к и р ӈ ы т _
рынноԓьыт аны ынкы	р ы н н о ԓ ь ы т _ а н ы _ ы н к ы _
гатэнмавԓенат маравынвэты ымы	г а т э н м а в ԓ е н а т _ м а р а в ы н в э т ы _ ы м ы _
ынӄэн пэрӄыён томгымкычгын опопы гым виин ёпынвыӈаеты мыёпыԓӄэвык эквэтгъи	ы н ӄ э н _ п э р ӄ ы ё н _ т о м г ы м к ы ч г ы н _ о п о п ы _ г ы м _ в и и н _ ё п ы н в ы ӈ а е т ы _ м ы ё п ы ԓ ӄ э в ы к _ э к в э т г ъ и _
умиԓгу ёпыԓӄэвынвэты аны	у м и ԓ г у _ ё п ы ԓ ӄ э в ы н в э т ы _ а н ы _
ёпынвыӈайыткынык гаёпытваԓен ԓюур рай тэкэм тэркэвтытвэма мооԓьычгын ӈоонӄо ининигъи ынкы атчыгъэ тумгэӄэй	ё п ы н в ы ӈ а й ы т к ы н ы к _ г а ё п ы т в а ԓ е н _ ԓ ю у р _ р а й _ т э к э м _ т э р к э в т ы т в э м а _ м о о ԓ ь ы ч г ы н _ ӈ о о н ӄ о _ и н и н и г ъ и _ ы н к ы _ а т ч ы г ъ э _ т у м г э ӄ э й _
умиԓгу ԓюур ынкы тэкэм	у м и ԓ г у _ ԓ ю у р _ ы н к ы _ т э к э м _
ёпынвыӈайык ӄача вуԓӄытвининэт	ё п ы н в ы ӈ а й ы к _ ӄ а ч а _ в у ԓ ӄ ы т в и н и н э т _
мууԓьыт нкы гаманэгранпатԓенат ынӄо эчги тэӈвуԓӄытвигъи ӄытгъи манэграԓьэты аны	м у у ԓ ь ы т _ н к ы _ г а м а н э г р а н п а т ԓ е н а т _ ы н ӄ о _ э ч г и _ т э ӈ в у ԓ ӄ ы т в и г ъ и _ ӄ ы т г ъ и _ м а н э г р а ԓ ь э т ы _ а н ы _
умиԓгунэ гачамэттаԓенат манэграԓьыт ӄынвэр пыкиргъи манэграԓьык	у м и ԓ г у н э _ г а ч а м э т т а ԓ е н а т _ м а н э г р а ԓ ь ы т _ ӄ ы н в э р _ п ы к и р г ъ и _ м а н э г р а ԓ ь ы к _
винвэӄэй ԓюнԓьутэ нынтыӄин эӄэԓьэ ԓюур ынкы вэнвыпаԓёмтэԓгъэ манэграгэӈкы ынкы нивӄинэт	в и н в э ӄ э й _ ԓ ю н ԓ ь у т э _ н ы н т ы ӄ и н _ э ӄ э ԓ ь э _ ԓ ю у р _ ы н к ы _ в э н в ы п а ԓ ё м т э ԓ г ъ э _ м а н э г р а г э ӈ к ы _ ы н к ы _ н и в ӄ и н э т _
ытри амыным атав игыр ныкитэ мынчамэттанат умиԓгун	ы т р и _ а м ы н ы м _ а т а в _ и г ы р _ н ы к и т э _ м ы н ч а м э т т а н а т _ у м и ԓ г у н _
рэмкын ынӄэнат рынноԓьыт омэԓгона миӈкыри	р э м к ы н _ ы н ӄ э н а т _ р ы н н о ԓ ь ы т _ о м э ԓ г о н а _ м и ӈ к ы р и _
ӄун ынан ганмыԓен ыргин ынанармачьын танӈармайӈын эчгиым ынӈин ивыпԓыткугъэт	ӄ у н _ ы н а н _ г а н м ы ԓ е н _ ы р г и н _ ы н а н а р м а ч ь ы н _ т а н ӈ а р м а й ӈ ы н _ э ч г и ы м _ ы н ӈ и н _ и в ы п ԓ ы т к у г ъ э т _
эӄэԓьыт винвэӄэй	э ӄ э ԓ ь ы т _ в и н в э ӄ э й _
эквэтгъи	э к в э т г ъ и _
ярагты ынӄо яраԓьыт	я р а г т ы _ ы н ӄ о _ я р а ԓ ь ы т _
ивнинэт миӈкъым ԓьунэт эӄэԓьыт	и в н и н э т _ м и ӈ к ъ ы м _ ԓ ь у н э т _ э ӄ э ԓ ь ы т _
ынӄо вэтгавчьомыԓьо иквъи	ы н ӄ о _ в э т г а в ч ь о м ы ԓ ь о _ и к в ъ и _
ӄуттиым пытӄырымагты	ӄ у т т и ы м _ п ы т ӄ ы р ы м а г т ы _
натчынат	н а т ч ы н а т _
ӈаԓгыԓ ӄэнъевык гаԓгатчыръоԓенат	ӈ а ԓ г ы ԓ _ ӄ э н ъ е в ы к _ г а ԓ г а т ч ы р ъ о ԓ е н а т _
гъыттъыма аны ԓюур нымгутыԓеӄинэт	г ъ ы т т ъ ы м а _ а н ы _ ԓ ю у р _ н ы м г у т ы ԓ е ӄ и н э т _
вусӄымчыку коԓё ныԓгинымэйыӈӄин мооԓьиӈын ныԓеӄин ӄанъявэчгэтты ԓюур эчги	в у с ӄ ы м ч ы к у _ к о ԓ ё _ н ы ԓ г и н ы м э й ы ӈ ӄ и н _ м о о ԓ ь и ӈ ы н _ н ы ԓ е ӄ и н _ ӄ а н ъ я в э ч г э т т ы _ ԓ ю у р _ э ч г и _
ынанэвтыԓяӈӄач ваԓьакы мачгаԓяк ивтытԓьэтэ нъыттъытриԓынэт аны гиинъыттъыт гапэнрыткоԓенат	ы н а н э в т ы ԓ я ӈ ӄ а ч _ в а ԓ ь а к ы _ м а ч г а ԓ я к _ и в т ы т ԓ ь э т э _ н ъ ы т т ъ ы т р и ԓ ы н э т _ а н ы _ г и и н ъ ы т т ъ ы т _ г а п э н р ы т к о ԓ е н а т _
моогты аны	м о о г т ы _ а н ы _
гэръиԓеԓин мооԓьыйӈын ораыттъыёԓягты ынӄо	г э р ъ и ԓ е ԓ и н _ м о о ԓ ь ы й ӈ ы н _ о р а ы т т ъ ы ё ԓ я г т ы _ ы н ӄ о _
намгогъан танԓымынӄо ыттъытриԓьюук аны	н а м г о г ъ а н _ т а н ԓ ы м ы н ӄ о _ ы т т ъ ы т р и ԓ ь ю у к _ а н ы _
ыттъыт гаӄоԓема	ы т т ъ ы т _ г а ӄ о ԓ е м а _
гапэнрыткоръоԓенат	г а п э н р ы т к о р ъ о ԓ е н а т _
ынкы мууриԓ гэкымъугчитԓин чинит ирвык	ы н к ы _ м у у р и ԓ _ г э к ы м ъ у г ч и т ԓ и н _ ч и н и т _ и р в ы к _
ӄэтвэтръугъэт таӈымыԓьо эвыр эквырга чымӄык гэегтэтԓинэт ынӄэнат ыргынан нэпиринэт маравтомго ынӄо нымытваӈӈогьат	ӄ э т в э т р ъ у г ъ э т _ т а ӈ ы м ы ԓ ь о _ э в ы р _ э к в ы р г а _ ч ы м ӄ ы к _ г э е г т э т ԓ и н э т _ ы н ӄ э н а т _ ы р г ы н а н _ н э п и р и н э т _ м а р а в т о м г о _ ы н ӄ о _ н ы м ы т в а ӈ ӈ о г ь а т _
рымагтэты таӈӄонпы ытри	р ы м а г т э т ы _ т а ӈ ӄ о н п ы _ ы т р и _
нотагты ӄытыԓьэтыԓьыт пэниннэт рачвыӈыԓьыт с ӈаԓвыԓьиӈын	н о т а г т ы _ ӄ ы т ы ԓ ь э т ы ԓ ь ы т _ п э н и н н э т _ р а ч в ы ӈ ы ԓ ь ы т _ с _ ӈ а ԓ в ы ԓ ь и ӈ ы н _
ыргин аръаԓя ныԓгинымкыӄин рыпэт	ы р г и н _ а р ъ а ԓ я _ н ы ԓ г и н ы м к ы ӄ и н _ р ы п э т _
ынанчинит ԓейвэ	ы н а н ч и н и т _ ԓ е й в э _
итыԓьын энмэн ганымытваԓенат тэӈыннэнчеэкэй	и т ы ԓ ь ы н _ э н м э н _ г а н ы м ы т в а ԓ е н а т _ т э ӈ ы н н э н ч е э к э й _
чавчывамкиӈын ԓыгэн	ч а в ч ы в а м к и ӈ ы н _ ԓ ы г э н _
ӄун	ӄ у н _
ныԓгинымкыӄин рагэнэвчыӈын	н ы ԓ г и н ы м к ы ӄ и н _ р а г э н э в ч ы ӈ ы н _
ӈаԓвыԓьиӈын ыргин аръаԓя ныԓгинымкыӄин	ӈ а ԓ в ы ԓ ь и ӈ ы н _ ы р г и н _ а р ъ а ԓ я _ н ы ԓ г и н ы м к ы ӄ и н _
рыпэт ынанчинит ԓейвэ итыԓьын	р ы п э т _ ы н а н ч и н и т _ ԓ е й в э _ и т ы ԓ ь ы н _
аны отчой ганымытваԓенат ынӄэнат	а н ы _ о т ч о й _ г а н ы м ы т в а ԓ е н а т _ ы н ӄ э н а т _
рамкиӈын ынраӄ ӄоԓ гатваԓен ынин нынны мотԓынто ынӄэн оравэтԓьан энмэч рэтинэнъэӄэӈгъэ ӄоԓ итык вуԓӄытвик гараеквэԓен мотԓынто ԓыгэн	р а м к и ӈ ы н _ ы н р а ӄ _ ӄ о ԓ _ г а т в а ԓ е н _ ы н и н _ н ы н н ы _ м о т ԓ ы н т о _ ы н ӄ э н _ о р а в э т ԓ ь а н _ э н м э ч _ р э т и н э н ъ э ӄ э ӈ г ъ э _ ӄ о ԓ _ и т ы к _ в у ԓ ӄ ы т в и к _ г а р а е к в э ԓ е н _ м о т ԓ ы н т о _ ԓ ы г э н _
танъямгарайпы ныпаԓёмтэԓгэԓеӄэн ԓюур	т а н ъ я м г а р а й п ы _ н ы п а ԓ ё м т э ԓ г э ԓ е ӄ э н _ ԓ ю у р _
ӄоԓераӄайык паԓёмтэԓгъэ тэкэм ынраӄ	ӄ о ԓ е р а ӄ а й ы к _ п а ԓ ё м т э ԓ г ъ э _ т э к э м _ ы н р а ӄ _
ӈъочьыраӄайык эвын ынкы ыргин	ӈ ъ о ч ь ы р а ӄ а й ы к _ э в ы н _ ы н к ы _ ы р г и н _
ытԓыгын нэмыӄэй нытваӄэн ныпавӄэнат	ы т ԓ ы г ы н _ н э м ы ӄ э й _ н ы т в а ӄ э н _ н ы п а в ӄ э н а т _
ӈирэӄ ӈъочьыӈэнӄайӄагтэ ӈан ӄаамотԓя	ӈ и р э ӄ _ ӈ ъ о ч ь ы ӈ э н ӄ а й ӄ а г т э _ ӈ а н _ ӄ а а м о т ԓ я _
вуԓӄытвик наӄам ынӄэн ыргин ытԓыгын	в у ԓ ӄ ы т в и к _ н а ӄ а м _ ы н ӄ э н _ ы р г и н _ ы т ԓ ы г ы н _
ӈъочьо гитԓин тъарӄааԓьо ԓюур вай мотԓынто	ӈ ъ о ч ь о _ г и т ԓ и н _ т ъ а р ӄ а а ԓ ь о _ ԓ ю у р _ в а й _ м о т ԓ ы н т о _
рагтыгъэ ынкъам	р а г т ы г ъ э _ ынкъам _
яраԓьыт ивнинэт тав эӄыԓпэ мынынръэйвэвын мургин яраӈы ынкъам мынгынтэв нотаӄаԓеты эӄыԓпэ	я р а ԓ ь ы т _ и в н и н э т _ т а в _ э ӄ ы ԓ п э _ м ы н ы н р ъ э й в э в ы н _ м у р г и н _ я р а ӈ ы _ ы н к ъ а м _ м ы н г ы н т э в _ н о т а ӄ а ԓ е т ы _ э ӄ ы ԓ п э _
нэнръэйвэвын яраӈы ынраӄ нэчвиркын чымӄык ӈэԓвыԓ	н э н р ъ э й в э в ы н _ я р а ӈ ы _ ы н р а ӄ _ н э ч в и р к ы н _ ч ы м ӄ ы к _ ӈ э ԓ в ы ԓ _
ԓыгэӄыԓпэ нэчвигъэн ӈэԓвыԓ мачамчымӈы ынӄо гэмгутыԓеԓинэт ԓыгэн	ԓ ы г э ӄ ы ԓ п э _ н э ч в и г ъ э н _ ӈ э ԓ в ы ԓ _ м а ч а м ч ы м ӈ ы _ ы н ӄ о _ г э м г у т ы ԓ е ԓ и н э т _ ԓ ы г э н _
нотаӄаԓеты киткитым анымкычаӈэты ӄэйыӄын	н о т а ӄ а ԓ е т ы _ к и т к и т ы м _ а н ы м к ы ч а ӈ э т ы _ ӄ э й ы ӄ ы н _
ынкы гатчытваԓен мотԓынто эчги	ы н к ы _ г а т ч ы т в а ԓ е н _ м о т ԓ ы н т о _ э ч г и _
эмгынунныкитэ нъэԓгъи	э м г ы н у н н ы к и т э _ н ъ э ԓ г ъ и _
тумгэӄэй мотԓынтоӄай гаваӈэйпаратԓен гамгарайпы	т у м г э ӄ э й _ м о т ԓ ы н т о ӄ а й _ г а в а ӈ э й п а р а т ԓ е н _ г а м г а р а й п ы _
нивӄин ик энмэн рэмкын	н и в ӄ и н _ и к _ э н м э н _ р э м к ы н _
вай ӄорачетыркын нивӄинэт	в а й _ ӄ о р а ч е т ы р к ы н _ н и в ӄ и н э т _
энараԓьыт мургинэт ӄутти	э н а р а ԓ ь ы т _ м у р г и н э т _ ӄ у т т и _
ик амын	и к _ а м ы н _
ивкэ мыниткэчитыркын ӈэԓвыԓ ӄытԓыгиым ынӄэн	и в к э _ м ы н и т к э ч и т ы р к ы н _ ӈ э ԓ в ы ԓ _ ӄ ы т ԓ ы г и ы м _ ы н ӄ э н _
гъыръунтэтԓин мотԓынто аны	г ъ ы р ъ у н т э т ԓ и н _ м о т ԓ ы н т о _ а н ы _
ынкы турӄуԓиԓьыръук мотԓынто	ы н к ы _ т у р ӄ у ԓ и ԓ ь ы р ъ у к _ м о т ԓ ы н т о _
гэԓӄутръуԓинэт гамгараеквэйӈын ԓыгэн ӈытоԓьын гапойгыма нынторъоӄэнат	г э ԓ ӄ у т р ъ у ԓ и н э т _ г а м г а р а е к в э й ӈ ы н _ ԓ ы г э н _ ӈ ы т о ԓ ь ы н _ г а п о й г ы м а _ н ы н т о р ъ о ӄ э н а т _
чиӈивэӄ гатэӈорма ынкы нымэйыӈӄин майӈымарав гатваԓен ԓыгэӄыԓпэ	ч и ӈ и в э ӄ _ г а т э ӈ о р м а _ ы н к ы _ н ы м э й ы ӈ ӄ и н _ м а й ӈ ы м а р а в _ г а т в а ԓ е н _ ԓ ы г э ӄ ы ԓ п э _
нэчвиткуйвын ӈаԓвыԓьиӈын ԓыгэн ӄун тымӈэнӈэн	н э ч в и т к у й в ы н _ ӈ а ԓ в ы ԓ ь и ӈ ы н _ ԓ ы г э н _ ӄ у н _ т ы м ӈ э н ӈ э н _
нытымӈэчвэткойвыӄэн чымӄыкым ԓыгэн оравэтԓьат нынмыткойвыӄэнат ынкы	н ы т ы м ӈ э ч в э т к о й в ы ӄ э н _ ч ы м ӄ ы к ы м _ ԓ ы г э н _ о р а в э т ԓ ь а т _ н ы н м ы т к о й в ы ӄ э н а т _ ы н к ы _
ԓыгэн ӄаачыко	ԓ ы г э н _ ӄ а а ч ы к о _
ԓымӈэ ярак ӄача ӄынвэр тэӈуйӈэ	ԓ ы м ӈ э _ я р а к _ ӄ а ч а _ ӄ ы н в э р _ т э ӈ у й ӈ э _
нъэԓгъи арака эвыр	н ъ э ԓ г ъ и _ а р а к а _ э в ы р _
ӈэԓвыԓ тэӈыннэн ԓёӈпэԓята итгъи ӄораӈы вачаӄым ӄытԓыги ынкы ӄоԓ гапэԓятԓен	ӈ э ԓ в ы ԓ _ т э ӈ ы н н э н _ ԓ ё ӈ п э ԓ я т а _ и т г ъ и _ ӄ о р а ӈ ы _ в а ч а ӄ ы м _ ӄ ы т ԓ ы г и _ ы н к ы _ ӄ о ԓ _ г а п э ԓ я т ԓ е н _
яраӈы раԓӄаӈынвык аны ӄынур пырӄаквыԓгын гэтэйкыԓин гаԓгэнъомравԓен аӄанчемавкы ваԓьын	я р а ӈ ы _ р а ԓ ӄ а ӈ ы н в ы к _ а н ы _ ӄ ы н у р _ п ы р ӄ а к в ы ԓ г ы н _ г э т э й к ы ԓ и н _ г а ԓ г э н ъ о м р а в ԓ е н _ а ӄ а н ч е м а в к ы _ в а ԓ ь ы н _
ӄытԓыги ынкы ӈирэӄ оравэтԓьат	ӄ ы т ԓ ы г и _ ы н к ы _ ӈ и р э ӄ _ о р а в э т ԓ ь а т _
гэтуйвынԓинэт гэӈээккэтэ ԓюур	г э т у й в ы н ԓ и н э т _ г э ӈ э э к к э т э _ ԓ ю у р _
пыкиргъи этратчыӈын рыркаӈэԓгиӈа	п ы к и р г ъ и _ э т р а т ч ы ӈ ы н _ р ы р к а ӈ э ԓ г и ӈ а _
нъэԓгынтакаӈатын ынӄэн яраӈы натаӈыԓвавын	н ъ э ԓ г ы н т а к а ӈ а т ы н _ ы н ӄ э н _ я р а ӈ ы _ н а т а ӈ ы ԓ в а в ы н _
рыпирӄык ымы ынраӄ намгон	р ы п и р ӄ ы к _ ы м ы _ ы н р а ӄ _ н а м г о н _
ивкы ынкы рыйигрывъэтэ	и в к ы _ ы н к ы _ р ы й и г р ы в ъ э т э _
мытрэнтыгыт ынпыначгыӄай ночыткоӄэн ынӄо высӄу нытчыӄин ынӄо нэмэ иквъэт ынпыначгыӄай	м ы т р э н т ы г ы т _ ы н п ы н а ч г ы ӄ а й _ н о ч ы т к о ӄ э н _ ы н ӄ о _ в ы с ӄ у _ н ы т ч ы ӄ и н _ ы н ӄ о _ н э м э _ и к в ъ э т _ ы н п ы н а ч г ы ӄ а й _
нивӄин гымнин йъэԓгытомгыт таӈатӄэԓгычайвыркыт ытръэч тэӈӄырым	н и в ӄ и н _ г ы м н и н _ й ъ э ԓ г ы т о м г ы т _ т а ӈ а т ӄ э ԓ г ы ч а й в ы р к ы т _ ы т р ъ э ч _ т э ӈ ӄ ы р ы м _
ӄыԓьугыткы ынӄо ытри	ӄ ы ԓ ь у г ы т к ы _ ы н ӄ о _ ы т р и _
иквъэт ынин варкыт эвыӈан йъэԓгытомгыт ынраӄым	и к в ъ э т _ ы н и н _ в а р к ы т _ э в ы ӈ а н _ й ъ э ԓ г ы т о м г ы т _ ы н р а ӄ ы м _
ръэмиӈкы кытъаткэ ынӄо эквэтгъэт ӄырэрынво ынӄэн ынӄэнат	р ъ э м и ӈ к ы _ к ы т ъ а т к э _ ы н ӄ о _ э к в э т г ъ э т _ ӄ ы р э р ы н в о _ ы н ӄ э н _ ы н ӄ э н а т _
ынӄэнатым гэӈээккэтэ нымытваӈӈогъат ынкы ӄынвэр ӄоԓ	ы н ӄ э н а т ы м _ г э ӈ э э к к э т э _ н ы м ы т в а ӈ ӈ о г ъ а т _ ы н к ы _ ӄ ы н в э р _ ӄ о ԓ _
итык вуԓӄытвик иквъи ынпыначгыӄай ӈааккагты ынӄо ынпыначгыӄая ԓёнтатԓыӈа	и т ы к _ в у ԓ ӄ ы т в и к _ и к в ъ и _ ы н п ы н а ч г ы ӄ а й _ ӈ а а к к а г т ы _ ы н ӄ о _ ы н п ы н а ч г ы ӄ а я _ ԓ ё н т а т ԓ ы ӈ а _
рыннин ытръэч ивнин гэквэтԓинэт ԓыгэн ынӈин высӄумчыку наӄам ԓыгэн ныԓгитымгыпиӈэтӄин ныпыӈкытԓетӄин аны котчой	р ы н н и н _ ы т р ъ э ч _ и в н и н _ г э к в э т ԓ и н э т _ ԓ ы г э н _ ы н ӈ и н _ в ы с ӄ у м ч ы к у _ н а ӄ а м _ ԓ ы г э н _ н ы ԓ г и т ы м г ы п и ӈ э т ӄ и н _ н ы п ы ӈ к ы т ԓ е т ӄ и н _ а н ы _ к о т ч о й _
гэԓеԓинэт ԓыгэн нотагты наӄам	г э ԓ е ԓ и н э т _ ԓ ы г э н _ н о т а г т ы _ н а ӄ а м _
ынпыначгыӄай ныянотыԓьатӄэн ӈээккэтэ	ы н п ы н а ч г ы ӄ а й _ н ы я н о т ы ԓ ь а т ӄ э н _ ӈ э э к к э т э _
наӄам	н а ӄ а м _
гэмо миӈкыри тыԓеркыт ԓюур	г э м о _ м и ӈ к ы р и _ т ы ԓ е р к ы т _ ԓ ю у р _
вай янотыԓьын	в а й _ я н о т ы ԓ ь ы н _
ръэгъи нэмыӄэй ытԓён	р ъ э г ъ и _ н э м ы ӄ э й _ ы т ԓ ё н _
гэмо ԓыгнин ынан	г э м о _ ԓ ы г н и н _ ы н а н _
ӈэвысӄэтэ эвын ԓыԓепгъи	ӈ э в ы с ӄ э т э _ э в ы н _ ԓ ы ԓ е п г ъ и _
ӄытԓыги энмэпы	ӄ ы т ԓ ы г и _ э н м э п ы _
гэкэмчичьэтԓинэт ынпыначгыӄай	г э к э м ч и ч ь э т ԓ и н э т _ ы н п ы н а ч г ы ӄ а й _
йъонэн ӈээккэтэ 	й ъ о н э н _ ӈ э э к к э т э _ _
эвын гэтъымымчеткуԓьэтԓин ынпыначгыӄай иквъи эвыр	э в ы н _ г э т ъ ы м ы м ч е т к у ԓ ь э т ԓ и н _ ы н п ы н а ч г ы ӄ а й _ и к в ъ и _ э в ы р _
ӈэнку рэпкиргъэ	ӈ э н к у _ р э п к и р г ъ э _
ӄымӈыԓтэԓгэ каракэгты ымыԓьо вагыргын ӄытвыԓьатгын нкъам ынан	ӄ ы м ӈ ы ԓ т э ԓ г э _ к а р а к э г т ы _ ы м ы ԓ ь о _ в а г ы р г ы н _ ӄ ы т в ы ԓ ь а т г ы н _ н к ъ а м _ ы н а н _
авык ыргынан ӄонпы нэрэтчыгыт таԓвапаԓӄаттагнэты ээ энмэч	а в ы к _ ы р г ы н а н _ ӄ о н п ы _ н э р э т ч ы г ы т _ т а ԓ в а п а ԓ ӄ а т т а г н э т ы _ э э _ э н м э ч _
гым ԓымӈэ рымагтэты	г ы м _ ԓ ы м ӈ э _ р ы м а г т э т ы _
аӄаягтаԓы тытваркын ԓыгэн ынӈин ивыпԓыткук въигъи ынпыначгыӄай	а ӄ а я г т а ԓ ы _ т ы т в а р к ы н _ ԓ ы г э н _ ы н ӈ и н _ и в ы п ԓ ы т к у к _ в ъ и г ъ и _ ы н п ы н а ч г ы ӄ а й _
миӈкыри ӄун ԓымӈэ ӄэйвэ аӄаягтаԓы эвын	м и ӈ к ы р и _ ӄ у н _ ԓ ы м ӈ э _ ӄ э й в э _ а ӄ а я г т а ԓ ы _ э в ы н _
миӈкы гэԓгитъымымчеткуԓин ээ	м и ӈ к ы _ г э ԓ г и т ъ ы м ы м ч е т к у ԓ и н _ э э _
ынӄэным амынан нъэԓгъи	ы н ӄ э н ы м _ а м ы н а н _ н ъ э ԓ г ъ и _
ӈэвысӄэт наӄам	ӈ э в ы с ӄ э т _ н а ӄ а м _
ытԓыгын въигъи ытԓёным рыгъеватыԓӄаӈынвыгъет атав эквэтгъи аны	ы т ԓ ы г ы н _ в ъ и г ъ и _ ы т ԓ ё н ы м _ р ы г ъ е в а т ы ԓ ӄ а ӈ ы н в ы г ъ е т _ а т а в _ э к в э т г ъ и _ а н ы _
котчой гэԓеԓин ӄооӈ ԓыгэн гэмо	к о т ч о й _ г э ԓ е ԓ и н _ ӄ о о ӈ _ ԓ ы г э н _ г э м о _
миӈкыри ӄынвэр вай ԓюур оравэтԓьан ӈытоԓьын ԓьунин ӈэвысӄэтэ ԓыгэным ынӄэн	м и ӈ к ы р и _ ӄ ы н в э р _ в а й _ ԓ ю у р _ о р а в э т ԓ ь а н _ ӈ ы т о ԓ ь ы н _ ԓ ь у н и н _ ӈ э в ы с ӄ э т э _ ԓ ы г э н ы м _ ы н ӄ э н _
ԓьоо оравэтԓьан ынӄэн ԓьунэӈу	ԓ ь о о _ о р а в э т ԓ ь а н _ ы н ӄ э н _ ԓ ь у н э ӈ у _
гэрэсӄивысӄычетԓин ченэтрачыкогты ынӄо нычимгъуӄин ӈэвысӄэт ынръа ӈан мэӈӄокэн оравэтԓьаӄай	г э р э с ӄ и в ы с ӄ ы ч е т ԓ и н _ ч е н э т р а ч ы к о г т ы _ ы н ӄ о _ н ы ч и м г ъ у ӄ и н _ ӈ э в ы с ӄ э т _ ы н р ъ а _ ӈ а н _ м э ӈ ӄ о к э н _ о р а в э т ԓ ь а ӄ а й _
наӄам ԓыгэӄыԓпэ	н а ӄ а м _ ԓ ы г э ӄ ы ԓ п э _
рэсӄиквъи ынкэгйит	р э с ӄ и к в ъ и _ ы н к э г й и т _
ԓыгэн пыкитчыӄиквъи ивыптэгнык ынӄо пыкиргъи	ԓ ы г э н _ п ы к и т ч ы ӄ и к в ъ и _ и в ы п т э г н ы к _ ы н ӄ о _ п ы к и р г ъ и _
ынкы ӄытԓыги ынӄэн кэрэкрэмкын аны	ы н к ы _ ӄ ы т ԓ ы г и _ ы н ӄ э н _ к э р э к р э м к ы н _ а н ы _
намӈыԓёйвын ынӄэн ӈэвысӄэт	н а м ӈ ы ԓ ё й в ы н _ ы н ӄ э н _ ӈ э в ы с ӄ э т _
гамӈыԓтэтԓен ӈэвысӄэт	г а м ӈ ы ԓ т э т ԓ е н _ ӈ э в ы с ӄ э т _
таӈымыԓьо тывъёонэн	т а ӈ ы м ы ԓ ь о _ т ы в ъ ё о н э н _
ынин нымытвагыргытымы ынӄэн	ы н и н _ н ы м ы т в а г ы р г ы т ы м ы _ ы н ӄ э н _
ӈан чит ярамкиӈык рээн нымытвагыргын	ӈ а н _ ч и т _ я р а м к и ӈ ы к _ р э э н _ н ы м ы т в а г ы р г ы н _
ынкъам ымы	ынкъам _ ы м ы _
йъэԓгытомгыт тывнэнат ытръэч ӄоон	й ъ э ԓ г ы т о м г ы т _ т ы в н э н а т _ ы т р ъ э ч _ ӄ о о н _
миӈкы варкыт ынкъам	м и ӈ к ы _ в а р к ы т _ ы н к ъ а м _
ымы йъэԓгытомгыт тывнэнат ытръэч ӄоон миӈкы	ы м ы _ й ъ э ԓ г ы т о м г ы т _ т ы в н э н а т _ ы т р ъ э ч _ ӄ о о н _ м и ӈ к ы _
варкыт нивӄинэт кэрэкыт энмэч морыкайпы ӄоԓ нитӄинэт	в а р к ы т _ н и в ӄ и н э т _ к э р э к ы т _ э н м э ч _ м о р ы к а й п ы _ ӄ о ԓ _ н и т ӄ и н э т _
ныгаԓяӄэнат ынӄо нанатвыгъан ӈэвысӄэт	н ы г а ԓ я ӄ э н а т _ ы н ӄ о _ н а н а т в ы г ъ а н _ ӈ э в ы с ӄ э т _
ӄуԓиныкитэ пыкиргъи	ӄ у ԓ и н ы к и т э _ п ы к и р г ъ и _
гэкэӈвыргыргын нэмэ кэрэкык ӄытԓыгиым	г э к э ӈ в ы р г ы р г ы н _ н э м э _ к э р э к ы к _ ӄ ы т ԓ ы г и ы м _
ӄунԓеԓюн рэмкын ԓюур	ӄ у н ԓ е ԓ ю н _ р э м к ы н _ ԓ ю у р _
вай ӄунԓеԓю ӈэнри ӄытгъи пынԓёнэнат	в а й _ ӄ у н ԓ е ԓ ю _ ӈ э н р и _ ӄ ы т г ъ и _ п ы н ԓ ё н э н а т _
вынэ вай тургин чакыгэт ӈутку	в ы н э _ вай _ т у р г и н _ ч а к ы г э т _ ӈ у т к у _
ако эԓымӈэ эмъим	а к о _ э ԓ ы м ӈ э _ э м ъ и м _
рай этки	р а й _ э т к и _
вынэ мытрэԓьуӈыркын	в ы н э _ м ы т р э ԓ ь у ӈ ы р к ы н _
ынӄо нотасӄычыкогты ӄытгъэт ынӄэнат ымыԓьо иийэ мэй ынӈатаԓым нымэԓьэв ӈэнку	ы н ӄ о _ н о т а с ӄ ы ч ы к о г т ы _ ӄ ы т г ъ э т _ ы н ӄ э н а т _ ы м ы ԓ ь о _ и и й э _ м э й _ ы н ӈ а т а ԓ ы м _ н ы м э ԓ ь э в _ ӈ э н к у _
нынымытваӄэн наӄам	н ы н ы м ы т в а ӄ э н _ н а ӄ а м _
ԓыгонмычыко ымы	ԓ ы г о н м ы ч ы к о _ ы м ы _
ӄун ырык	ӄ у н _ ы р ы к _
ротванвык эвыча наӄам ӈэнку ныԓгэӄэргатӄэн ээкэтэ	р о т в а н в ы к _ э в ы ч а _ н а ӄ а м _ ӈ э н к у _ н ы ԓ г э ӄ э р г а т ӄ э н _ э э к э т э _
энмэч гъывэӄучитэ ӈэнку нынымытваӄэнат ныԓгиныгтиӈӄин ынин ывэӄуч ыӈко иквъи ӄунԓеԓю ынӄы ӄытваркын нымэԓьэв ынӄэн миӈкы эӄэԓьэ ныԓӄырирӄин чакыгэт	э н м э ч _ г ъ ы в э ӄ у ч и т э _ ӈ э н к у _ н ы н ы м ы т в а ӄ э н а т _ н ы ԓ г и н ы г т и ӈ ӄ и н _ ы н и н _ ы в э ӄ у ч _ ы ӈ к о _ и к в ъ и _ ӄ у н ԓ е ԓ ю _ ы н ӄ ы _ ӄ ы т в а р к ы н _ н ы м э ԓ ь э в _ ы н ӄ э н _ м и ӈ к ы _ э ӄ э ԓ ь э _ н ы ԓ ӄ ы р и р ӄ и н _ ч а к ы г э т _
ынкъам ынӄэната ганатчыӈатԓен	ынкъам _ ы н ӄ э н а т а _ г а н а т ч ы ӈ а т ԓ е н _
кэрэкитэ ынкъым гаԓгэкоргавԓен чакыгэт рыпэт ӄун ынӄэн чакэно нинъэйӈэвӄин ӄунԓеԓюнэ	к э р э к и т э _ ы н к ъ ы м _ г а ԓ г э к о р г а в ԓ е н _ ч а к ы г э т _ р ы п э т _ ӄ у н _ ы н ӄ э н _ ч а к э н о _ н и н ъ э й ӈ э в ӄ и н _ ӄ у н ԓ е ԓ ю н э _
амкоргава аԓымы ӄырымэн чакыгэт ытръэч ӈавйъеԓгытомгын	а м к о р г а в а _ а ԓ ы м ы _ ӄ ы р ы м э н _ ч а к ы г э т _ ы т р ъ э ч _ ӈ а в й ъ е ԓ г ы т о м г ы н _
ынӄо гэквэтԓин ӄунԓеԓин рэмкын гамаравыԓьатԓен гэмгэԓымынкы	ы н ӄ о _ г э к в э т ԓ и н _ ӄ у н ԓ е ԓ и н _ р э м к ы н _ г а м а р а в ы ԓ ь а т ԓ е н _ г э м г э ԓ ы м ы н к ы _
ӄунԓеԓю миӈкыри ӄун ныԓӄыритъюуӄин ӄунԓеԓюнэ гэмгээӄэԓьэ ынкъам ынӄэната гамаравыԓьатԓен гамгааӄаԓьэты	ӄ у н ԓ е ԓ ю _ м и ӈ к ы р и _ ӄ у н _ н ы ԓ ӄ ы р и т ъ ю у ӄ и н _ ӄ у н ԓ е ԓ ю н э _ г э м г э э ӄ э ԓ ь э _ ы н к ъ а м _ ы н ӄ э н а т а _ г а м а р а в ы ԓ ь а т ԓ е н _ г а м г а а ӄ а ԓ ь э т ы _
ӄынвэр энмэч гэԓгинымкэвԓин ынин ӈэԓвыԓ ӄунԓеԓюн	ӄ ы н в э р _ э н м э ч _ г э ԓ г и н ы м к э в ԓ и н _ ы н и н _ ӈ э ԓ в ы ԓ _ ӄ у н ԓ е ԓ ю н _
аԓымы чит ӄунԓеԓю нотайпы	а ԓ ы м ы _ ч и т _ ӄ у н ԓ е ԓ ю _ н о т а й п ы _
ԓейвэ итыԓьын ԓыгэн ӄун	ԓ е й в э _ и т ы ԓ ь ы н _ ԓ ы г э н _ ӄ у н _
ӈъочьыӄай чит	ӈ ъ о ч ь ы ӄ а й _ ч и т _
эквырга нутэк таӈамнымытвата гаԓгэмчытвэԓен чама гэӈэӈытвиԓин чинит	э к в ы р г а _ н у т э к _ т а ӈ а м н ы м ы т в а т а _ г а ԓ г э м ч ы т в э ԓ е н _ ч а м а _ г э ӈ э ӈ ы т в и ԓ и н _ ч и н и т _
ыԓеӄинэт ӈанӄэн нэмэ пытԓяӄ нъэӄэԓьыгынтэвӄинэт ԓюур	ы ԓ е ӄ и н э т _ ӈ а н ӄ э н _ н э м э _ п ы т ԓ я ӄ _ н ъ э ӄ э ԓ ь ы г ы н т э в ӄ и н э т _ ԓ ю у р _
ынкы тыԓянвык	ы н к ы _ т ы ԓ я н в ы к _
нэӈыръыԓьун ӄоԓ	н э ӈ ы р ъ ы ԓ ь у н _ ӄ о ԓ _
оравэтԓьан ӄытԓыги	о р а в э т ԓ ь а н _ ӄ ы т ԓ ы г и _
нэмыӄэй ԓыгиейвэԓӄэй нэпиригъэнгаӄэтывъэӈӈоԓен эвын нанрагтатын ярак пыкирык наномаатын ынӄэн ӄытԓыги энмэн	н э м ы ӄ э й _ ԓ ы г и е й в э ԓ ӄ э й _ н э п и р и г ъ э н г а ӄ э т ы в ъ э ӈ ӈ о ԓ е н _ э в ы н _ н а н р а г т а т ы н _ я р а к _ п ы к и р ы к _ н а н о м а а т ы н _ ы н ӄ э н _ ӄ ы т ԓ ы г и _ э н м э н _
уӄӄэмӄэй ӄытԓыги нэмыӄэй ԓыгиейвэԓӄэй нэпиригъэнгаӄэтывъэӈӈоԓен эвын нанрагтатын ярак пыкирык наномаатын ынӄэн ӄытԓыги	у ӄ ӄ э м ӄ э й _ ӄ ы т ԓ ы г и _ н э м ы ӄ э й _ ԓ ы г и е й в э ԓ ӄ э й _ н э п и р и г ъ э н г а ӄ э т ы в ъ э ӈ ӈ о ԓ е н _ э в ы н _ н а н р а г т а т ы н _ я р а к _ п ы к и р ы к _ н а н о м а а т ы н _ ы н ӄ э н _ ӄ ы т ԓ ы г и _
энмэн уӄӄэмӄэй ԓыгэн	э н м э н _ у ӄ ӄ э м ӄ э й _ ԓ ы г э н _
ӄун ӄунԓэԓюнэ	ӄ у н _ ӄ у н ԓ э ԓ ю н э _
нутэк тэӈэмԓьуткутэ гэнымкэвԓин ынин	н у т э к _ т э ӈ э м ԓ ь у т к у т э _ г э н ы м к э в ԓ и н _ ы н и н _
итрэтӄэй юур	и т р э т ӄ э й _ ю у р _
вай ӄуԓивуԓӄытвик нэмэ	в а й _ ӄ у ԓ и в у ԓ ӄ ы т в и к _ н э м э _
гакаӈыԓьымкиӈын ныԓячаӄэн	г а к а ӈ ы ԓ ь ы м к и ӈ ы н _ н ы ԓ я ч а ӄ э н _
ынӈатаԓым ныԓгинымкыӄин	ы н ӈ а т а ԓ ы м _ н ы ԓ г и н ы м к ы ӄ и н _
ӄытԓыги эӄэԓьын нэмэ ԓыгэн	ӄ ы т ԓ ы г и _ э ӄ э ԓ ь ы н _ н э м э _ ԓ ы г э н _
кыткаракэгъет пыкитчыӄиквъэт ынкы	к ы т к а р а к э г ъ е т _ п ы к и т ч ы ӄ и к в ъ э т _ ы н к ы _
пыкиргъэт ынкъам нымӈыԓёӄэнат	п ы к и р г ъ э т _ ынкъам _ н ы м ӈ ы ԓ ё ӄ э н а т _
ванэван ӄыԓьугыткы ӄытвыгыткы гэмо моргынан ымыԓьэты	в а н э в а н _ ӄ ы ԓ ь у г ы т к ы _ ӄ ы т в ы г ы т к ы _ г э м о _ м о р г ы н а н _ ы м ы ԓ ь э т ы _
ӄунԓеԓюн рэмкын вэнԓыги танԓёӈытва нэнтынэт ӄунԓеԓюн рэмкын аԓымы ымы ынкы нытваӄэн ыргин чакыгэт ӈавйъеԓгытомгын эквэтгъи	ӄ у н ԓ е ԓ ю н _ р э м к ы н _ в э н ԓ ы г и _ т а н ԓ ё ӈ ы т в а _ н э н т ы н э т _ ӄ у н ԓ е ԓ ю н _ р э м к ы н _ а ԓ ы м ы _ ы м ы _ ы н к ы _ н ы т в а ӄ э н _ ы р г и н _ ч а к ы г э т _ ӈ а в й ъ е ԓ г ы т о м г ы н _ э к в э т г ъ и _
ынӄэн этратчыӈын	ы н ӄ э н _ э т р а т ч ы ӈ ы н _
ако ынраӄ ынӄэн	а к о _ ы н р а ӄ _ ы н ӄ э н _
ръэт нэркыԓейвын ӄунԓеԓюргин юур вай	р ъ э т _ н э р к ы ԓ е й в ы н _ ӄ у н ԓ е ԓ ю р г и н _ ю у р _ в а й _
вытратычгатгъэ этратчыӈын ӄунԓеԓю нычимгъуӄин ынӄо нивӄинэт ӄунԓеԓюн тумгыт	в ы т р а т ы ч г а т г ъ э _ э т р а т ч ы ӈ ы н _ ӄ у н ԓ е ԓ ю _ н ы ч и м г ъ у ӄ и н _ ы н ӄ о _ н и в ӄ и н э т _ ӄ у н ԓ е ԓ ю н _ т у м г ы т _
ӄунԓеԓюнэ ивнинэт эвнэгынтэвкэ мачынан ынйъомык аны нычимгъуӄин	ӄ у н ԓ е ԓ ю н э _ и в н и н э т _ э в н э г ы н т э в к э _ м а ч ы н а н _ ы н й ъ о м ы к _ а н ы _ н ы ч и м г ъ у ӄ и н _
ӄунԓеԓю нивӄин	ӄ у н ԓ е ԓ ю _ н и в ӄ и н _
ымӈан этъопэԓ миӈкыри мынынтынэт	ы м ӈ а н _ э т ъ о п э ԓ _ м и ӈ к ы р и _ м ы н ы н т ы н э т _
наӄам ӄунԓеԓюн тумгыт	н а ӄ а м _ ӄ у н ԓ е ԓ ю н _ т у м г ы т _
ԓыгитъэркинэт нынныт ыргинэт 	ԓ ы г и т ъ э р к и н э т _ н ы н н ы т _ ы р г и н э т _ _
пэтывтычгын ирэпиӄытъым вэтгавкытувъе чеграйӈо	п э т ы в т ы ч г ы н _ и р э п и ӄ ы т ъ ы м _ в э т г а в к ы т у в ъ е _ ч е г р а й ӈ о _
ыттъыӄопай риӄуӄӄэй ынкъам уӄӄэмэӄэй ӈан	ы т т ъ ы ӄ о п а й _ р и ӄ у ӄ ӄ э й _ ы н к ъ а м _ у ӄ ӄ э м э ӄ э й _ ӈ а н _
нутэк ԓьоо ынкъам ӄутти нэмыӄэй	н у т э к _ ԓ ь о о _ ынкъам _ ӄ у т т и _ н э м ы ӄ э й _
нутэк ԓьооӄагтэ ӄынвэр ивнинэт ӄунԓеԓюнэ ынкъам	н у т э к _ ԓ ь о о ӄ а г т э _ ӄ ы н в э р _ и в н и н э т _ ӄ у н ԓ е ԓ ю н э _ ы н к ъ а м _
ынӈин ӄаанэтԓета	ы н ӈ и н _ ӄ а а н э т ԓ е т а _
мынԓеркын ытри моогьат ӄаанэтԓетыԓьатык	м ы н ԓ е р к ы н _ ы т р и _ м о о г ь а т _ ӄ а а н э т ԓ е т ы ԓ ь а т ы к _
гамгорвэты аны ӈоты	г а м г о р в э т ы _ а н ы _ ӈ о т ы _
ԓыгэймэквъэт эӄэԓьыт ӄунԓеԓю гиръытвыԓин	ԓ ы г э й м э к в ъ э т _ э ӄ э ԓ ь ы т _ ӄ у н ԓ е ԓ ю _ г и р ъ ы т в ы ԓ и н _
тэӈиръыкэ нъэԓгъи амыным	т э ӈ и р ъ ы к э _ н ъ э ԓ г ъ и _ а м ы н ы м _
ныԓгитэнтымгэтӄин ӈаргынэн таӈайъыткынка ымы ӄунԓеԓю иръытвинэӈу гаӄъоԓяԓен кытгыргоԓягты ӄынур ины ӄъоԓяпԓыткой	н ы ԓ г и т э н т ы м г э т ӄ и н _ ӈ а р г ы н э н _ т а ӈ а й ъ ы т к ы н к а _ ы м ы _ ӄ у н ԓ е ԓ ю _ и р ъ ы т в и н э ӈ у _ г а ӄ ъ о ԓ я ԓ е н _ к ы т г ы р г о ԓ я г т ы _ ӄ ы н у р _ и н ы _ ӄ ъ о ԓ я п ԓ ы т к о й _
нэръэпыӄэн эръэпыма эвыр	н э р ъ э п ы ӄ э н _ э р ъ э п ы м а _ э в ы р _
ныйъэтӄин ӈаргынэн ԓыгэӄыԓпэ рэченма ныпиӈэръуӄин къаԓейпыма 	н ы й ъ э т ӄ и н _ ӈ а р г ы н э н _ ԓ ы г э ӄ ы ԓ п э _ р э ч е н м а _ н ы п и ӈ э р ъ у ӄ и н _ к ъ а ԓ е й п ы м а _ _
нывъятԓьоӄэн ԓейпыма ныпыԓмыръоӄэн эвыр	н ы в ъ я т ԓ ь о ӄ э н _ ԓ е й п ы м а _ н ы п ы ԓ м ы р ъ о ӄ э н _ э в ы р _
тантэнмавыпԓыткой орвэты ӄытгъи орвык вакъой аны тэнԓыԓечурмэтэ гапыԓмыръочгатԓен вачаӄ вэнԓыги	т а н т э н м а в ы п ԓ ы т к о й _ о р в э т ы _ ӄ ы т г ъ и _ о р в ы к _ в а к ъ о й _ а н ы _ т э н ԓ ы ԓ е ч у р м э т э _ г а п ы ԓ м ы р ъ о ч г а т ԓ е н _ в а ч а ӄ _ в э н ԓ ы г и _
ынӈин ныԓеӄинэт ынкъам ныянотӄэн тумгэӄэй ирэпиӄытъым аны ныԓеӄинэт атав ынӈин	ы н ӈ и н _ н ы ԓ е ӄ и н э т _ ынкъам _ н ы я н о т ӄ э н _ т у м г э ӄ э й _ и р э п и ӄ ы т ъ ы м _ а н ы _ н ы ԓ е ӄ и н э т _ а т а в _ ы н ӈ и н _
вуԓӄытвий ӄынвэр нывиԓгъэт ынкы ӄунԓеԓюн мараврат ынкы	в у ԓ ӄ ы т в и й _ ӄ ы н в э р _ н ы в и ԓ г ъ э т _ ы н к ы _ ӄ у н ԓ е ԓ ю н _ м а р а в р а т _ ы н к ы _
нэмэ нымэԓеттыԓеӄин ӈаргынэн ӄунԓеԓюнэ ивнинэт	н э м э _ н ы м э ԓ е т т ы ԓ е ӄ и н _ ӈ а р г ы н э н _ ӄ у н ԓ е ԓ ю н э _ и в н и н э т _
тумгыт нэмэ ӄунԓеԓюнэ ивнинэт	т у м г ы т _ н э м э _ ӄ у н ԓ е ԓ ю н э _ и в н и н э т _
пэԓӄынтэтгъэт ораяаԓегты ӈоонӄо тыԓек ивнинэт мэрынрэӄэй тумгыт	п э ԓ ӄ ы н т э т г ъ э т _ о р а я а ԓ е г т ы _ ӈ о о н ӄ о _ т ы ԓ е к _ и в н и н э т _ м э р ы н р э ӄ э й _ т у м г ы т _
мынчамэттанат 	м ы н ч а м э т т а н а т _ _
ӈаан ныйыԓӄатчаӄэнат тумгиирыкым эвыр ночӄэн ынӄо ӈааанӄо	ӈ а а н _ н ы й ы ԓ ӄ а т ч а ӄ э н а т _ т у м г и и р ы к ы м _ э в ы р _ н о ч ӄ э н _ ы н ӄ о _ ӈ а а а н ӄ о _
тыԓек ивнинэт нэмэ	т ы ԓ е к _ и в н и н э т _ н э м э _
тумгыт эченур ирвыт таӈымыԓьо	т у м г ы т _ э ч е н у р _ и р в ы т _ т а ӈ ы м ы ԓ ь о _
мынынԓейвынэт юрэӄ ӈаан ыръыйыԓӄэтыркыт эвытԓым виин амыргынан ытръэч	м ы н ы н ԓ е й в ы н э т _ ю р э ӄ _ ӈ а а н _ ы р ъ ы й ы ԓ ӄ э т ы р к ы т _ э в ы т ԓ ы м _ в и и н _ а м ы р г ы н а н _ ы т р ъ э ч _
пойгыт мынынрынэт ик тумгыӄэгти ӄунԓеԓюн айыԓгыкыԓьэнат	п о й г ы т _ м ы н ы н р ы н э т _ и к _ т у м г ы ӄ э г т и _ ӄ у н ԓ е ԓ ю н _ а й ы ԓ г ы к ы ԓ ь э н а т _
нымэԓьэв гатэнмавръоԓенат начамэттанат ынӄэн йыԓӄыԓьыгинив энмэч пыкиргъэт ырык	н ы м э ԓ ь э в _ г а т э н м а в р ъ о ԓ е н а т _ н а ч а м э т т а н а т _ ы н ӄ э н _ й ы ԓ ӄ ы ԓ ь ы г и н и в _ э н м э ч _ п ы к и р г ъ э т _ ы р ы к _
эвын ныйыԓӄатчаӄэнат нэмэ ивнинэт	э в ы н _ н ы й ы ԓ ӄ а т ч а ӄ э н а т _ н э м э _ и в н и н э т _
ӄунԓеԓюнэ эчги	ӄ у н ԓ е ԓ ю н э _ э ч г и _
мытрэпԓыткуӈынэт майынԓяк ирвыт ынраӄ йыԓӄыԓьыт	м ы т р э п ԓ ы т к у ӈ ы н э т _ м а й ы н ԓ я к _ и р в ы т _ ы н р а ӄ _ й ы ԓ ӄ ы ԓ ь ы т _
мынынмыткойвынат ԓыгэн	м ы н ы н м ы т к о й в ы н а т _ ԓ ы г э н _
ынкы орвык ыпэ майынԓяк	ы н к ы _ о р в ы к _ ы п э _ м а й ы н ԓ я к _
ирвыт ынраӄ йыԓӄыԓьыт мынынмыткойвынат	и р в ы т _ ы н р а ӄ _ й ы ԓ ӄ ы ԓ ь ы т _ м ы н ы н м ы т к о й в ы н а т _
ԓыгэн ынкы	ԓ ы г э н _ ы н к ы _
орвык ыпэ намгонат ирвыт	о р в ы к _ ы п э _ н а м г о н а т _ и р в ы т _
тыгинрыԓьэтык орвэпы ԓыгэн	т ы г и н р ы ԓ ь э т ы к _ о р в э п ы _ ԓ ы г э н _
ныԓгэӄэйыԓӄатчаӄэнат аӄаԓьымкычгын нэпԓыткунэт майынԓяк ирвыт ынӄо	н ы ԓ г э ӄ э й ы ԓ ӄ а т ч а ӄ э н а т _ а ӄ а ԓ ь ы м к ы ч г ы н _ н э п ԓ ы т к у н э т _ м а й ы н ԓ я к _ и р в ы т _ ы н ӄ о _
ивнинэт нэмэ	и в н и н э т _ н э м э _
ӄунԓеԓюнэ ԓыгэн ынкы нытынпычерӄэнат	ӄ у н ԓ е ԓ ю н э _ ԓ ы г э н _ ы н к ы _ н ы т ы н п ы ч е р ӄ э н а т _
эӄэԓьыт аны нырэԓиԓӄутръуӄинэт эӄэԓьыгинив наӄам эвыр чыкэевыԓьын орвэпы нэнарэрыԓьатӄэнат ченэтэрвэты	э ӄ э ԓ ь ы т _ а н ы _ н ы р э ԓ и ԓ ӄ у т р ъ у ӄ и н э т _ э ӄ э ԓ ь ы г и н и в _ н а ӄ а м _ э в ы р _ ч ы к э е в ы ԓ ь ы н _ о р в э п ы _ н э н а р э р ы ԓ ь а т ӄ э н а т _ ч е н э т э р в э т ы _
наӄам ԓьук ныԓвавӄэнат ирвыт	н а ӄ а м _ ԓ ь у к _ н ы ԓ в а в ӄ э н а т _ и р в ы т _
аны ынкы наԓгэнмыткойвынат	а н ы _ ы н к ы _ н а ԓ г э н м ы т к о й в ы н а т _
эӄэԓьыт ӄунԓеԓюнэ мараврата гынтэвыԓьыт тиӈурэ нычеӈкайвыӄэнат нэмэ ынкы тэӈыткунинэт	э ӄ э ԓ ь ы т _ ӄ у н ԓ е ԓ ю н э _ м а р а в р а т а _ г ы н т э в ы ԓ ь ы т _ т и ӈ у р э _ н ы ч е ӈ к а й в ы ӄ э н а т _ н э м э _ ы н к ы _ т э ӈ ы т к у н и н э т _
эӄэԓьыт ӄунԓеԓюнэ мараврата аԓымы тъэркинэӄэй ӄунԓеԓюн	э ӄ э ԓ ь ы т _ ӄ у н ԓ е ԓ ю н э _ м а р а в р а т а _ а ԓ ы м ы _ т ъ э р к и н э ӄ э й _ ӄ у н ԓ е ԓ ю н _
мараврат ӄоныръым гагыттавъяԓенат	м а р а в р а т _ ӄ о н ы р ъ ы м _ г а г ы т т а в ъ я ԓ е н а т _
ӄунԓеԓюнэ таӈымыԓьо выятӄаат ынкы ӈэԓвыԓьу нагтатын	ӄ у н ԓ е ԓ ю н э _ т а ӈ ы м ы ԓ ь о _ в ы я т ӄ а а т _ ы н к ы _ ӈ э ԓ в ы ԓ ь у _ н а г т а т ы н _
ярагты ынкы ӄутти анмыка рытъёттэ ӄаагтатыԓьо	я р а г т ы _ ы н к ы _ ӄ у т т и _ а н м ы к а _ р ы т ъ ё т т э _ ӄ а а г т а т ы ԓ ь о _
нэԓгынэт ӈан оравэтԓьат ынвэр	н э ԓ г ы н э т _ ӈ а н _ о р а в э т ԓ ь а т _ ы н в э р _
ӄунԓеԓюргин ӈаԓвыԓьиӈын гэԓгимкэтԓин миӈкыри ӄун	ӄ у н ԓ е ԓ ю р г и н _ ӈ а ԓ в ы ԓ ь и ӈ ы н _ г э ԓ г и м к э т ԓ и н _ м и ӈ к ы р и _ ӄ у н _
танԓымынӄо эмиткэйвык наӄам гамгаԓымынӄо	т а н ԓ ы м ы н ӄ о _ э м и т к э й в ы к _ н а ӄ а м _ г а м г а ԓ ы м ы н ӄ о _
ныԓӄыритъюуӄин эӄэԓьэ ӄунԓеԓю ӄынвэр уйӈэ нъэԓгъи эӄэԓьыкэ аны	н ы ԓ ӄ ы р и т ъ ю у ӄ и н _ э ӄ э ԓ ь э _ ӄ у н ԓ е ԓ ю _ ӄ ы н в э р _ у й ӈ э _ н ъ э ԓ г ъ и _ э ӄ э ԓ ь ы к э _ а н ы _
ӄунԓеԓю ганӈэнайпыԓен нивӄин ԓюур	ӄ у н ԓ е ԓ ю _ г а н ӈ э н а й п ы ԓ е н _ н и в ӄ и н _ ԓ ю у р _
ӄоԓ ӄуԓиԓьэтгъи ӄԓявыԓ ынӄэн	ӄ о ԓ _ ӄ у ԓ и ԓ ь э т г ъ и _ ӄ ԓ я в ы ԓ _ ы н ӄ э н _
мотԓынтона ынӄо иквъи ӄунԓеԓю ытръэч ԓыгимиӈкы	м о т ԓ ы н т о н а _ ы н ӄ о _ и к в ъ и _ ӄ у н ԓ е ԓ ю _ ы т р ъ э ч _ ԓ ы г и м и ӈ к ы _
варкын ивнин ӄунԓеԓюнэ уӄӄэмӄэй ынӄо уӄӄэмӄэйынэ ивнинэт	в а р к ы н _ и в н и н _ ӄ у н ԓ е ԓ ю н э _ у ӄ ӄ э м ӄ э й _ ы н ӄ о _ у ӄ ӄ э м ӄ э й ы н э _ и в н и н э т _
ынкъам мыныюмӈимык нанмынат ынӄэнат рымӈэвъёно	ынкъам _ м ы н ы ю м ӈ и м ы к _ н а н м ы н а т _ ы н ӄ э н а т _ р ы м ӈ э в ъ ё н о _
ынӄо нымӈиӄин уӄӄэмӄэй нутэк ԓьоо нивӄин уӄӄэмӄэй ынкы нэмэ	ы н ӄ о _ н ы м ӈ и ӄ и н _ у ӄ ӄ э м ӄ э й _ н у т э к _ ԓ ь о о _ н и в ӄ и н _ у ӄ ӄ э м ӄ э й _ ы н к ы _ н э м э _
мытрэмӈигъэ ынкъым вэчьым	м ы т р э м ӈ и г ъ э _ ы н к ъ ы м _ в э ч ь ы м _
мытрэԓьуӈын мотԓынто ыныкит мытранмыӈын майӈывопӄы вэчьым ӄун мытрэԓьуӈын мотԓынто ынӄо	м ы т р э ԓ ь у ӈ ы н _ м о т ԓ ы н т о _ ы н ы к и т _ м ы т р а н м ы ӈ ы н _ м а й ӈ ы в о п ӄ ы _ в э ч ь ы м _ ӄ у н _ м ы т р э ԓ ь у ӈ ы н _ м о т ԓ ы н т о _ ы н ӄ о _
пԓыткугъэт мыӈик аны	п ԓ ы т к у г ъ э т _ м ы ӈ и к _ а н ы _
ӈан гэмгутыԓеԓинэт ԓыгэн	ӈ а н _ г э м г у т ы ԓ е ԓ и н э т _ ԓ ы г э н _
ӄооӈ миӈкыри ръаянраӈаеты ымтыԓяӈэт ныръэтгэтаӄэн	ӄ о о ӈ _ м и ӈ к ы р и _ р ъ а я н р а ӈ а е т ы _ ы м т ы ԓ я ӈ э т _ н ы р ъ э т г э т а ӄ э н _
ирэпиӄытъым наӄам ытԓён эԓгаргаканъёԓьын ԓюур ирэпиӄытъым иквъи вэчьым ӄун ынӄэн уӄӄэмӄэй	и р э п и ӄ ы т ъ ы м _ н а ӄ а м _ ы т ԓ ё н _ э ԓ г а р г а к а н ъ ё ԓ ь ы н _ ԓ ю у р _ и р э п и ӄ ы т ъ ы м _ и к в ъ и _ в э ч ь ы м _ ӄ у н _ ы н ӄ э н _ у ӄ ӄ э м ӄ э й _
нивӄин вынэатав ԓыгэн ынкэгйит мынԓеркын 	н и в ӄ и н _ в ы н э а т а в _ ԓ ы г э н _ ы н к э г й и т _ м ы н ԓ е р к ы н _ _
эпԓеэн ръэӈэй ынӄэн аны	э п ԓ е э н _ р ъ э ӈ э й _ ы н ӄ э н _ а н ы _
нымгутыԓеӄинэт атав	н ы м г у т ы ԓ е ӄ и н э т _ а т а в _
ԓыгэн ынкэгйит ԓюур	ԓ ы г э н _ ы н к э г й и т _ ԓ ю у р _
ӄэгԓынангэр вытрэтгъи янраӈагчыӈын	ӄ э г ԓ ы н а н г э р _ в ы т р э т г ъ и _ я н р а ӈ а г ч ы ӈ ы н _
ынкэсӄыкым нывытрэтӄин ӄынур майӈыпырӄаквыԓгын 	ы н к э с ӄ ы к ы м _ н ы в ы т р э т ӄ и н _ ӄ ы н у р _ м а й ӈ ы п ы р ӄ а к в ы ԓ г ы н _ _
ӄытԓыги майӈывопӄачгын ынкэгиӈкы рэвиквъэт ынӄэн майӈыянраӈайгэӈкы	ӄ ы т ԓ ы г и _ м а й ӈ ы в о п ӄ а ч г ы н _ ы н к э г и ӈ к ы _ р э в и к в ъ э т _ ы н ӄ э н _ м а й ӈ ы я н р а ӈ а й г э ӈ к ы _
ынӄо эквэтгъэт ӈэнри ӈэйыттэтгъэт	ы н ӄ о _ э к в э т г ъ э т _ ӈ э н р и _ ӈ э й ы т т э т г ъ э т _
ӈыроргарэ	ӈ ы р о р г а р э _
ирэпиӄытъым уӄӄэмӄэй ынкъам ӄунԓеԓю	и р э п и ӄ ы т ъ ы м _ у ӄ ӄ э м ӄ э й _ ы н к ъ а м _ ӄ у н ԓ е ԓ ю _
нычамэттаӄэн вопӄайӈын ӄынвэр нэԓгинэймэвын ынкы	н ы ч а м э т т а ӄ э н _ в о п ӄ а й ӈ ы н _ ӄ ы н в э р _ н э ԓ г и н э й м э в ы н _ ы н к ы _
ытԓёнайӈын нытԓытвачгатӄэн ӄынур пырӄаквыԓгычгын ԓюур нэтиӈутчиргъэн ӈыронԓяӈо	ы т ԓ ё н а й ӈ ы н _ н ы т ԓ ы т в а ч г а т ӄ э н _ ӄ ы н у р _ п ы р ӄ а к в ы ԓ г ы ч г ы н _ ԓ ю у р _ н э т и ӈ у т ч и р г ъ э н _ ӈ ы р о н ԓ я ӈ о _
ынкы нэтэӈкыргун вопӄайӈын ынӄо	ы н к ы _ н э т э ӈ к ы р г у н _ в о п ӄ а й ӈ ы н _ ы н ӄ о _
нэнкэвчитчевын ӈайӄаԓетԓы нэныпкирэтгъэн ярак нэнвэнӈын	н э н к э в ч и т ч е в ы н _ ӈ а й ӄ а ԓ е т ԓ ы _ н э н ы п к и р э т г ъ э н _ я р а к _ н э н в э н ӈ ы н _
ӈэвысӄэтэ ынӄо ивнинэт уӄӄэмӄэйынэ гэмӈиԓин уӄӄэмӄэй энмэн	ӈ э в ы с ӄ э т э _ ы н ӄ о _ и в н и н э т _ у ӄ ӄ э м ӄ э й ы н э _ г э м ӈ и ԓ и н _ у ӄ ӄ э м ӄ э й _ э н м э н _
йъэԓыги ныӄуӈычгэтӄин нинивӄин ӄунԓеԓюнэ энмэч эӄыԓпэ ӄырэԓьуӈыркын мотԓынто ынӄо	й ъ э ԓ ы г и _ н ы ӄ у ӈ ы ч г э т ӄ и н _ н и н и в ӄ и н _ ӄ у н ԓ е ԓ ю н э _ э н м э ч _ э ӄ ы ԓ п э _ ӄ ы р э ԓ ь у ӈ ы р к ы н _ м о т ԓ ы н т о _ ы н ӄ о _
уӄӄэмӄэй иквъи ынӄэн	у ӄ ӄ э м ӄ э й _ и к в ъ и _ ы н ӄ э н _
нымным мытрамӈыԓёйвыӈын ӄоԓ ынкэкин оравэтԓьан ытръэч ӄун нэмэԓым нотасӄычыковты ваԓьыраԓьыт чамъам мытрэԓьуӈынэт ынӄо пԓыткуй вэтгавкы уӄӄэмӄэй ӄунԓеԓю	н ы м н ы м _ м ы т р а м ӈ ы ԓ ё й в ы ӈ ы н _ ӄ о ԓ _ ы н к э к и н _ о р а в э т ԓ ь а н _ ы т р ъ э ч _ ӄ у н _ н э м э ԓ ы м _ н о т а с ӄ ы ч ы к о в т ы _ в а ԓ ь ы р а ԓ ь ы т _ ч а м ъ а м _ м ы т р э ԓ ь у ӈ ы н э т _ ы н ӄ о _ п ԓ ы т к у й _ в э т г а в к ы _ у ӄ ӄ э м ӄ э й _ ӄ у н ԓ е ԓ ю _
гивԓин ынӄо ръэйвэтгъэт ынкъам мууԓӄытгъэт	г и в ԓ и н _ ы н ӄ о _ р ъ э й в э т г ъ э т _ ынкъам _ м у у ԓ ӄ ы т г ъ э т _
нэмэ гэмгутыԓеԓьэтԓинэт котчой ныянрагакаӈыԓьатӄэнат ӈыроргарэ ирэпиӄытъым	н э м э _ г э м г у т ы ԓ е ԓ ь э т ԓ и н э т _ к о т ч о й _ н ы я н р а г а к а ӈ ы ԓ ь а т ӄ э н а т _ ӈ ы р о р г а р э _ и р э п и ӄ ы т ъ ы м _
ӄунԓеԓю уӄӄэмӄэй ирэпиӄытъым	ӄ у н ԓ е ԓ ю _ у ӄ ӄ э м ӄ э й _ и р э п и ӄ ы т ъ ы м _
нэмэ ныёпыԓӄэвыԓьатӄэн тэнԓымынкыри тыԓяма нэмэ ивнинэт тумгыт нивӄин уӄӄэмӄэй ныянотӄэн ирэпиӄытъым ԓюур	н э м э _ н ы ё п ы ԓ ӄ э в ы ԓ ь а т ӄ э н _ т э н ԓ ы м ы н к ы р и _ т ы ԓ я м а _ н э м э _ и в н и н э т _ т у м г ы т _ н и в ӄ и н _ у ӄ ӄ э м ӄ э й _ н ы я н о т ӄ э н _ и р э п и ӄ ы т ъ ы м _ ԓ ю у р _
вай пыкиргъэт ӄэгԓынангэр	в а й _ п ы к и р г ъ э т _ ӄ э г ԓ ы н а н г э р _
ынкы нытваӄэн тытыԓ нотасӄычыкогты	ы н к ы _ н ы т в а ӄ э н _ т ы т ы ԓ _ н о т а с ӄ ы ч ы к о г т ы _
ӄынур имчьэчукин ивнинэт	ӄ ы н у р _ и м ч ь э ч у к и н _ и в н и н э т _
ӄунԓеԓюнэ гапэрӄытваԓен ӄунԓеԓю наӄам	ӄ у н ԓ е ԓ ю н э _ г а п э р ӄ ы т в а ԓ е н _ ӄ у н ԓ е ԓ ю _ н а ӄ а м _
эԓгарӄааԓьын ынин	э ԓ г а р ӄ а а ԓ ь ы н _ ы н и н _
гакаӈӄор эмъаԓвэнӄор ныԓгининъыӄин	г а к а ӈ ӄ о р _ э м ъ а ԓ в э н ӄ о р _ н ы ԓ г и н и н ъ ы ӄ и н _
наӄам майӈыԓеӈгыргыԓьын	н а ӄ а м _ м а й ӈ ы ԓ е ӈ г ы р г ы ԓ ь ы н _
ынин таӈымыԓьэты ниԓгыӄин	ы н и н _ т а ӈ ы м ы ԓ ь э т ы _ н и ԓ г ы ӄ и н _
ӄунԓеԓюн увик миӈкыри ӄун эԓгувтычгыԓьын эԓгыӄонагԓьан	ӄ у н ԓ е ԓ ю н _ у в и к _ м и ӈ к ы р и _ ӄ у н _ э ԓ г у в т ы ч г ы ԓ ь ы н _ э ԓ г ы ӄ о н а г ԓ ь а н _
иԓгыԓиԓьын ԓыгэн ӄун ымыԓьэты ниԓгыӄин ынин орвоор	и ԓ г ы ԓ и ԓ ь ы н _ ԓ ы г э н _ ӄ у н _ ы м ы ԓ ь э т ы _ н и ԓ г ы ӄ и н _ ы н и н _ о р в о о р _
эвыр ӄооԓгыт ԓюур аатчеӄӄай	э в ы р _ ӄ о о ԓ г ы т _ ԓ ю у р _ а а т ч е ӄ ӄ а й _
ӈытогъэ янор эмԓевыт рынтоӈаннэн	ӈ ы т о г ъ э _ я н о р _ э м ԓ е в ы т _ р ы н т о ӈ а н н э н _
тэнԓымынкыри нытԓепыткуԓьэтӄин ынӄо	т э н ԓ ы м ы н к ы р и _ н ы т ԓ е п ы т к у ԓ ь э т ӄ и н _ ы н ӄ о _
ӄынвэр ымыԓьэты увик рынтоӈаннэн	ӄ ы н в э р _ ы м ы ԓ ь э т ы _ у в и к _ р ы н т о ӈ а н н э н _
ынӄо ӈытосӄычатгъэ таӈванэван ныԓьунин атчытваԓьын	ы н ӄ о _ ӈ ы т о с ӄ ы ч а т г ъ э _ т а ӈ в а н э в а н _ н ы ԓ ь у н и н _ а т ч ы т в а ԓ ь ы н _
ӄунԓеԓю эчги	ӄ у н ԓ е ԓ ю _ э ч г и _
ӈытосӄычатгъэ	ӈ ы т о с ӄ ы ч а т г ъ э _
аатчеӄӄай пэнрысӄычаннэн	а а т ч е ӄ ӄ а й _ п э н р ы с ӄ ы ч а н н э н _
ытԓён ӄунԓеԓюнэ аны	ы т ԓ ё н _ ӄ у н ԓ е ԓ ю н э _ а н ы _
гыттакавӄооԓгиӈа гинэгнинтыԓин ӄунԓеԓюнэ ынык	г ы т т а к а в ӄ о о ԓ г и ӈ а _ г и н э г н и н т ы ԓ и н _ ӄ у н ԓ е ԓ ю н э _ ы н ы к _
гиӈкы	г и ӈ к ы _
рирэннин ԓюур ынӄэн	р и р э н н и н _ ԓ ю у р _ ы н ӄ э н _
аԓякватыткынык	а ԓ я к в а т ы т к ы н ы к _
аԓякват 	а ԓ я к в а т _ _
ӈан орвывынгыргык	ӈ а н _ о р в ы в ы н г ы р г ы к _
рывоԓватытваԓьын ӈан риивтэгнык	р ы в о ԓ в а т ы т в а ԓ ь ы н _ ӈ а н _ р и и в т э г н ы к _
ынӄэн ынкъам	ы н ӄ э н _ ынкъам _
ынкы рирэннин	ы н к ы _ р и р э н н и н _
ынӄо пиринин томгэнырыкы рыԓьэтэннин	ы н ӄ о _ п и р и н и н _ т о м г э н ы р ы к ы _ р ы ԓ ь э т э н н и н _
ынкы намӈыԓёйвын	ы н к ы _ н а м ӈ ы ԓ ё й в ы н _
ванэван ымы ночнэнат	в а н э в а н _ ы м ы _ н о ч н э н а т _
миӈкыри ӄун	м и ӈ к ы р и _ ӄ у н _
амайыԓгавкы аатчеӄӄай нэтэнринӈынъюн	а м а й ы ԓ г а в к ы _ а а т ч е ӄ ӄ а й _ н э т э н р и н ӈ ы н ъ ю н _
ынӄэн пэрэёӄай ынкъам намӈыԓён нэмэ ӄынвэр пыӈыԓтэԓгъэ ытԓёнаӄай нивӄин ынраӄым	ы н ӄ э н _ п э р э ё ӄ а й _ ы н к ъ а м _ н а м ӈ ы ԓ ё н _ н э м э _ ӄ ы н в э р _ п ы ӈ ы ԓ т э ԓ г ъ э _ ы т ԓ ё н а ӄ а й _ н и в ӄ и н _ ы н р а ӄ ы м _
иам ԓыгэн ӄун ныԓгиниквыӄин гэтэйкыԓин энмычгын ыныграк камԓеԓы	и а м _ ԓ ы г э н _ ӄ у н _ н ы ԓ г и н и к в ы ӄ и н _ г э т э й к ы ԓ и н _ э н м ы ч г ы н _ ы н ы г р а к _ к а м ԓ е ԓ ы _
иӈӄун мэӈин эвнэԓӄыткэ нитгъэн	и ӈ ӄ у н _ м э ӈ и н _ э в н э ԓ ӄ ы т к э _ н и т г ъ э н _
ынӄо игыр ԓьэԓеӈкы ынраӄ гимԓыттъивыԓин энмээм ынӄэным	ы н ӄ о _ и г ы р _ ԓ ь э ԓ е ӈ к ы _ ы н р а ӄ _ г и м ԓ ы т т ъ и в ы ԓ и н _ э н м э э м _ ы н ӄ э н ы м _
энмычгын гатарӄойвэнӈачгатԓен таӈэтъо таӈъаӄаттаты гэнъэтԓин ынӄо пԓыткуй пыӈыԓтэԓык	э н м ы ч г ы н _ г а т а р ӄ о й в э н ӈ а ч г а т ԓ е н _ т а ӈ э т ъ о _ т а ӈ ъ а ӄ а т т а т ы _ г э н ъ э т ԓ и н _ ы н ӄ о _ п ԓ ы т к у й _ п ы ӈ ы ԓ т э ԓ ы к _
ӄунԓеԓюнэ ивнин ынӄо ивнинэт	ӄ у н ԓ е ԓ ю н э _ и в н и н _ ы н ӄ о _ и в н и н э т _
тумгыт ӄунԓеԓюнэ ынӄо ӄытгъи ынръа ӈан гаԓгэчаӈыттатчаԓенат	т у м г ы т _ ӄ у н ԓ е ԓ ю н э _ ы н ӄ о _ ӄ ы т г ъ и _ ы н р ъ а _ ӈ а н _ г а ԓ г э ч а ӈ ы т т а т ч а ԓ е н а т _
ивнинэт ӄунԓеԓюнэ нивӄинэт ытри	и в н и н э т _ ӄ у н ԓ е ԓ ю н э _ н и в ӄ и н э т _ ы т р и _
наӄам ӄунԓеԓю ныԓгэнанӈэнаӄэн гатваԓен тэӈвэнԓыги ԓёӈытва нынтыӄин	н а ӄ а м _ ӄ у н ԓ е ԓ ю _ н ы ԓ г э н а н ӈ э н а ӄ э н _ г а т в а ԓ е н _ т э ӈ в э н ԓ ы г и _ ԓ ё ӈ ы т в а _ н ы н т ы ӄ и н _
ынӄо ивнинэт ӄунԓеԓюнэ ынӈатаԓ ымы мытратвыгыт эвыр	ы н ӄ о _ и в н и н э т _ ӄ у н ԓ е ԓ ю н э _ ы н ӈ а т а ԓ _ ы м ы _ м ы т р а т в ы г ы т _ э в ы р _
ранмыӈыткы мотԓынто эчги ынӈин	р а н м ы ӈ ы т к ы _ м о т ԓ ы н т о _ э ч г и _ ы н ӈ и н _
ивыпԓыткук ынӄэнат ӄунԓеԓю ганӈэнайпыԓен ынкъам гантосӄычатԓен пойгын	и в ы п ԓ ы т к у к _ ы н ӄ э н а т _ ӄ у н ԓ е ԓ ю _ г а н ӈ э н а й п ы ԓ е н _ ынкъам _ г а н т о с ӄ ы ч а т ԓ е н _ п о й г ы н _
пиринин ынӄо ярачыкогты пиӈкугъи ынкы	п и р и н и н _ ы н ӄ о _ я р а ч ы к о г т ы _ п и ӈ к у г ъ и _ ы н к ы _
тымыткойвынэнат таӈымыԓьо ынӄо ӈытогъэ аатчеӄӄай ивнин ӄунԓеԓюнэ	т ы м ы т к о й в ы н э н а т _ т а ӈ ы м ы ԓ ь о _ ы н ӄ о _ ӈ ы т о г ъ э _ а а т ч е ӄ ӄ а й _ и в н и н _ ӄ у н ԓ е ԓ ю н э _
энмэч моогты	э н м э ч _ м о о г т ы _
ӄыԓӄытги ынкъам ӄавэръэпыгэ	ӄ ы ԓ ӄ ы т г и _ ы н к ъ а м _ ӄ а в э р ъ э п ы г э _
аатчеӄӄай ӄытгъи наӄам иръычвыткыԓьин уйӈэ ԓыгэн ӄун ӄэтывъэӈӈоԓьыӄай ынкъам пыкиргъи	а а т ч е ӄ ӄ а й _ ӄ ы т г ъ и _ н а ӄ а м _ и р ъ ы ч в ы т к ы ԓ ь и н _ у й ӈ э _ ԓ ы г э н _ ӄ у н _ ӄ э т ы в ъ э ӈ ӈ о ԓ ь ы ӄ а й _ ы н к ъ а м _ п ы к и р г ъ и _
муук ӄоныръым нэмэ ирэпиӄытъымынэ	м у у к _ ӄ о н ы р ъ ы м _ н э м э _ и р э п и ӄ ы т ъ ы м ы н э _
гэнԓьэтэтԓин нанавэръэпатъёгъан ԓыгитэӈэвиръэ ынӄо эквэтгъэт нэмэ ынкэгйит аны ӄынвэр вуԓӄытвий	г э н ԓ ь э т э т ԓ и н _ н а н а в э р ъ э п а т ъ ё г ъ а н _ ԓ ы г и т э ӈ э в и р ъ э _ ы н ӄ о _ э к в э т г ъ э т _ н э м э _ ы н к э г й и т _ а н ы _ ӄ ы н в э р _ в у ԓ ӄ ы т в и й _
ԓюур ынкы эмԓыттъэнмиӈын нэԓьун ӄэгԓынангэт ынӈин ваԓьын гэтэйкыԓин	ԓ ю у р _ ы н к ы _ э м ԓ ы т т ъ э н м и ӈ ы н _ н э ԓ ь у н _ ӄ э г ԓ ы н а н г э т _ ы н ӈ и н _ в а ԓ ь ы н _ г э т э й к ы ԓ и н _
пыкиргъэт ынкы ԓыгэн	п ы к и р г ъ э т _ ы н к ы _ ԓ ы г э н _
гыргоԓягты ныгитэӄин наӄам	г ы р г о ԓ я г т ы _ н ы г и т э ӄ и н _ н а ӄ а м _
вусӄымчыку мачванэван нывытрэтын тарӄойвэйӈын ынкы ӄэйыӄын чимгьугъи тумгэӄэй ӄунԓеԓю нивӄин миӈкыри мынынтын ынӄо ивнин	в у с ӄ ы м ч ы к у _ м а ч в а н э в а н _ н ы в ы т р э т ы н _ т а р ӄ о й в э й ӈ ы н _ ы н к ы _ ӄ э й ы ӄ ы н _ ч и м г ь у г ъ и _ т у м г э ӄ э й _ ӄ у н ԓ е ԓ ю _ н и в ӄ и н _ м и ӈ к ы р и _ м ы н ы н т ы н _ ы н ӄ о _ и в н и н _
ӄунԓеԓюнэ ирэпиӄытъым ынӄо	ӄ у н ԓ е ԓ ю н э _ и р э п и ӄ ы т ъ ы м _ ы н ӄ о _
гэквэтԓин ирэпиӄытъым нэмэ пыкиргъи	г э к в э т ԓ и н _ и р э п и ӄ ы т ъ ы м _ н э м э _ п ы к и р г ъ и _
ирэпиӄытъым аԓваԓьэнаръэтгыпы	и р э п и ӄ ы т ъ ы м _ а ԓ в а ԓ ь э н а р ъ э т г ы п ы _
ивнин гыттэпычьын маравраткэн ынӄо кыԓгытвынин	и в н и н _ г ы т т э п ы ч ь ы н _ м а р а в р а т к э н _ ы н ӄ о _ к ы ԓ г ы т в ы н и н _
ынин эԓгар эмъаԓвэнӄор наӄам майӈыԓьэӈгыргыԓьын эвыр	ы н и н _ э ԓ г а р _ э м ъ а ԓ в э н ӄ о р _ н а ӄ а м _ м а й ӈ ы ԓ ь э ӈ г ы р г ы ԓ ь ы н _ э в ы р _
нирвыӄинэт ынин ԓьэӈгыргыт ӄаӈаэвԓявэԓгиӈын рырыткунин	н и р в ы ӄ и н э т _ ы н и н _ ԓ ь э ӈ г ы р г ы т _ ӄ а ӈ а э в ԓ я в э ԓ г и ӈ ы н _ р ы р ы т к у н и н _
ынкъам ръаратвавэԓнэн эмъаԓвэнӄор ынӄо чигԓемнин эмъаԓвэнӄор аны ԓыгэн эмъаԓвэнӄааӄай	ынкъам _ р ъ а р а т в а в э ԓ н э н _ э м ъ а ԓ в э н ӄ о р _ ы н ӄ о _ ч и г ԓ е м н и н _ э м ъ а ԓ в э н ӄ о р _ а н ы _ ԓ ы г э н _ э м ъ а ԓ в э н ӄ а а ӄ а й _
гавэԓёвъяԓгыткоръэԓяԓен	г а в э ԓ ё в ъ я ԓ г ы т к о р ъ э ԓ я ԓ е н _
гыргоԓягты ԓыгэн таӈамԓьэӈгырга ныкэӈунэӈэткуӄин	г ы р г о ԓ я г т ы _ ԓ ы г э н _ т а ӈ а м ԓ ь э ӈ г ы р г а _ н ы к э ӈ у н э ӈ э т к у ӄ и н _
гыргоԓягты тыԓяма ԓыгэн ытръэч	г ы р г о ԓ я г т ы _ т ы ԓ я м а _ ԓ ы г э н _ ы т р ъ э ч _
яаԓгыткат ныкэнчиӄыткуӄинэт ӄуйвик яноткэнатым ымы таӈванэван нытрунэт	я а ԓ г ы т к а т _ н ы к э н ч и ӄ ы т к у ӄ и н э т _ ӄ у й в и к _ я н о т к э н а т ы м _ ы м ы _ т а ӈ в а н э в а н _ н ы т р у н э т _
ӄуйвик	ӄ у й в и к _
ԓюур ынкэсӄэтгъи эԓгар эмъаԓвэнӄор	ԓ ю у р _ ы н к э с ӄ э т г ъ и _ э ԓ г а р _ э м ъ а ԓ в э н ӄ о р _
ынко рэмыннуӈгъи этын	ы н к о _ р э м ы н н у ӈ г ъ и _ э т ы н _
ынин тумгэӄэй ӄунԓеԓю ынӄо	ы н и н _ т у м г э ӄ э й _ ӄ у н ԓ е ԓ ю _ ы н ӄ о _
гиԓгыйиквиԓин ӄунԓеԓю гыргоԓягты эмъаԓвэӄааӄайым	г и ԓ г ы й и к в и ԓ и н _ ӄ у н ԓ е ԓ ю _ г ы р г о ԓ я г т ы _ э м ъ а ԓ в э ӄ а а ӄ а й ы м _
ынкэсӄык ныкытъыматӄэн ынкъым тинунин	ы н к э с ӄ ы к _ н ы к ы т ъ ы м а т ӄ э н _ ы н к ъ ы м _ т и н у н и н _
ынкасӄэты этын эмъаԓвэнӄаата ынкы	ы н к а с ӄ э т ы _ э т ы н _ э м ъ а ԓ в э н ӄ а а т а _ ы н к ы _
таӈэтъо гакоргавԓен ӄунԓеԓю ынӄо нэнайӈоӄэн	т а ӈ э т ъ о _ г а к о р г а в ԓ е н _ ӄ у н ԓ е ԓ ю _ ы н ӄ о _ н э н а й ӈ о ӄ э н _
ынкэсӄык эмъаԓвэнӄор миӈкыри	ы н к э с ӄ ы к _ э м ъ а ԓ в э н ӄ о р _ м и ӈ к ы р и _
ӄун амкоргава	ӄ у н _ а м к о р г а в а _
гакоргавԓен ӄунԓеԓю ынӄо нэнайӈоӄэн ынкэсӄык эмъаԓвэнӄор миӈкыри ӄун	г а к о р г а в ԓ е н _ ӄ у н ԓ е ԓ ю _ ы н ӄ о _ н э н а й ӈ о ӄ э н _ ы н к э с ӄ ы к _ э м ъ а ԓ в э н ӄ о р _ м и ӈ к ы р и _ ӄ у н _
амкоргава ынӄо тиӈунинэт тумгыт ынкъам	а м к о р г а в а _ ы н ӄ о _ т и ӈ у н и н э т _ т у м г ы т _ ы н к ъ а м _
раԓегъат ԓыгэн эвтыԓягты	р а ԓ е г ъ а т _ ԓ ы г э н _ э в т ы ԓ я г т ы _
амыным эвын ынкы нытвачгатӄэн мотԓынтон ярайӈын	а м ы н ы м _ э в ы н _ ы н к ы _ н ы т в а ч г а т ӄ э н _ м о т ԓ ы н т о н _ я р а й ӈ ы н _
эвын ныԓгэнымайыӈӄэначгын	э в ы н _ н ы ԓ г э н ы м а й ы ӈ ӄ э н а ч г ы н _
вынэ ныкитэ вусӄымчыку	в ы н э _ н ы к и т э _ в у с ӄ ы м ч ы к у _
пыкиргъэт ынкы	п ы к и р г ъ э т _ ы н к ы _
ратагнык ӄунԓеԓюнэ чиниткин эвторвыӄай	р а т а г н ы к _ ӄ у н ԓ е ԓ ю н э _ ч и н и т к и н _ э в т о р в ы ӄ а й _
ратчаннэн ынкъам ыръэ нэнаркыпчыткоӄэнат вивтыт ԓюур рай кыявычгатгъэ мотԓынтойӈын	р а т ч а н н э н _ ы н к ъ а м _ ы р ъ э _ н э н а р к ы п ч ы т к о ӄ э н а т _ в и в т ы т _ ԓ ю у р _ р а й _ к ы я в ы ч г а т г ъ э _ м о т ԓ ы н т о й ӈ ы н _
нивӄин ӄунԓеԓюнэ нинивӄин энмэч эӄыԓпэ ӄынтогэ вай	н и в ӄ и н _ ӄ у н ԓ е ԓ ю н э _ н и н и в ӄ и н _ э н м э ч _ э ӄ ы ԓ п э _ ӄ ы н т о г э _ в а й _
мытъатчаркынэгыт еп	м ы т ъ а т ч а р к ы н э г ы т _ е п _
тыкынкэргыпатыркын вынэ	т ы к ы н к э р г ы п а т ы р к ы н _ в ы н э _
нэнаԓгэнтэрӈыръовӄэнат ынин нэнэнэт ӄытԓыгъим	н э н а ԓ г э н т э р ӈ ы р ъ о в ӄ э н а т _ ы н и н _ н э н э н э т _ ӄ ы т ԓ ы г ъ и м _
нэнатынпычерӄэнат чиниткин	н э н а т ы н п ы ч е р ӄ э н а т _ ч и н и т к и н _
эккэӄэгти ивнин	э к к э ӄ э г т и _ и в н и н _
ӄунԓеԓюнэ эӄыԓпэ аны	ӄ у н ԓ е ԓ ю н э _ э ӄ ы ԓ п э _ а н ы _
ӄынтогэ атчавооргэгыт еп ӈэвъэн	ӄ ы н т о г э _ а т ч а в о о р г э г ы т _ е п _ ӈ э в ъ э н _
кэргыпыркын ӄытԓыгъим	к э р г ы п ы р к ы н _ ӄ ы т ԓ ы г ъ и м _
	_
тымыркынэн эчги ынӄэн тымыткопԓытконэнат эккэӄэгти	т ы м ы р к ы н э н _ э ч г и _ ы н ӄ э н _ т ы м ы т к о п ԓ ы т к о н э н а т _ э к к э ӄ э г т и _
пԓыткугъи ченэтрайыръытагэнӈыԓьатык ԓюур	п ԓ ы т к у г ъ и _ ч е н э т р а й ы р ъ ы т а г э н ӈ ы ԓ ь а т ы к _ ԓ ю у р _
гыргоԓягты пэӈкочгатгъэ мотԓынтойӈын	г ы р г о ԓ я г т ы _ п э ӈ к о ч г а т г ъ э _ м о т ԓ ы н т о й ӈ ы н _
рынооргык ӄачайпы рыранэн	р ы н о о р г ы к _ ӄ а ч а й п ы _ р ы р а н э н _
рэтэм ынкъам пиӈкугъи	р э т э м _ ы н к ъ а м _ п и ӈ к у г ъ и _
ынӄоры гапойгыма нутэсӄык иргъи ӄунԓеԓюӄэйынэ	ы н ӄ о р ы _ г а п о й г ы м а _ н у т э с ӄ ы к _ и р г ъ и _ ӄ у н ԓ е ԓ ю ӄ э й ы н э _
ынанчиӄай гапойгыма пэнрынэн аны гапойгыԓьатмаравԓенат ынкы	ы н а н ч и ӄ а й _ г а п о й г ы м а _ п э н р ы н э н _ а н ы _ г а п о й г ы ԓ ь а т м а р а в ԓ е н а т _ ы н к ы _
ӄынвэр ԓюур	ӄ ы н в э р _ ԓ ю у р _
пойгыкэн пыԓвынтын эрэтгъи эмуттэ чит гапойгыԓьатԓен	п о й г ы к э н _ п ы ԓ в ы н т ы н _ э р э т г ъ и _ э м у т т э _ ч и т _ г а п о й г ы ԓ ь а т ԓ е н _
ӄэйыӄын ынӄо ӄунԓеԓюнэ мынгычвэтконэн уйӈэ амынгыка рытчынин	ӄ э й ы ӄ ы н _ ы н ӄ о _ ӄ у н ԓ е ԓ ю н э _ м ы н г ы ч в э т к о н э н _ у й ӈ э _ а м ы н г ы к а _ р ы т ч ы н и н _
ынӄо	ы н ӄ о _
пынԓёнэн ӄунԓеԓюнэ ыныкым танӈырат тумгу	п ы н ԓ ё н э н _ ӄ у н ԓ е ԓ ю н э _ ы н ы к ы м _ т а н ӈ ы р а т _ т у м г у _
нитӄинэт ынӄэнат гаймычьыԓьыт наӄам ымы ӈэԓвыԓьык ӄорагынрэтыԓьо нитӄинэт	н и т ӄ и н э т _ ы н ӄ э н а т _ г а й м ы ч ь ы ԓ ь ы т _ н а ӄ а м _ ы м ы _ ӈ э ԓ в ы ԓ ь ы к _ ӄ о р а г ы н р э т ы ԓ ь о _ н и т ӄ и н э т _
ӈъочьыӄагтэ ытԓёным ныԓгитэӈычьэтӄин ныԓгинымэԓьэв нынымытваӄэн	ӈ ъ о ч ь ы ӄ а г т э _ ы т ԓ ё н ы м _ н ы ԓ г и т э ӈ ы ч ь э т ӄ и н _ н ы ԓ г и н ы м э ԓ ь э в _ н ы н ы м ы т в а ӄ э н _
эвыр ынӄэн ӈэнри ныӄамэтвасӄэвӄэн	э в ы р _ ы н ӄ э н _ ӈ э н р и _ н ы ӄ а м э т в а с ӄ э в ӄ э н _
гаймычьыԓьэты ынӄо	г а й м ы ч ь ы ԓ ь э т ы _ ы н ӄ о _
ӄунԓеԓюнэ ивнинэт	ӄ у н ԓ е ԓ ю н э _ и в н и н э т _
тумгыт ӈэԓвыԓ	т у м г ы т _ ӈ э ԓ в ы ԓ _
йытыйгот ӄынтыгыткы	й ы т ы й г о т _ ӄ ы н т ы г ы т к ы _
мачынан ынан чинит	м а ч ы н а н _ ы н а н _ ч и н и т _
ӈэԓвыԓ нырэннин	ӈ э ԓ в ы ԓ _ н ы р э н н и н _
ынӄо ӄунԓеԓю	ы н ӄ о _ ӄ у н ԓ е ԓ ю _
танӈырагты	т а н ӈ ы р а г т ы _
ӄытгъи пыкиргъи	ӄ ы т г ъ и _ п ы к и р г ъ и _
танӈырак ивниэт	т а н ӈ ы р а к _ и в н и э т _
ӄунԓеԓюнэ ԓюур вай	ӄ у н ԓ е ԓ ю н э _ ԓ ю у р _ в а й _
моогъат ырыткуԓьэтык ытри ӄонԓяԓёна ӄунԓеԓюнэ тытыԓ рыныманнэн	м о о г ъ а т _ ы р ы т к у ԓ ь э т ы к _ ы т р и _ ӄ о н ԓ я ԓ ё н а _ ӄ у н ԓ е ԓ ю н э _ т ы т ы ԓ _ р ы н ы м а н н э н _
ынкъам ԓыгэн ынкы	ынкъам _ ԓ ы г э н _ ы н к ы _
нуԓвыӄин аны	н у ԓ в ы ӄ и н _ а н ы _
ынкы ԓыгэн	ы н к ы _ ԓ ы г э н _
ярачыко ныԓӄэгнэвъюуӄин	я р а ч ы к о _ н ы ԓ ӄ э г н э в ъ ю у ӄ и н _
ԓюур ытри	ԓ ю у р _ ы т р и _
тэӈъэмикэ нъэԓгъэт	т э ӈ ъ э м и к э _ н ъ э ԓ г ъ э т _
